일자,기관 합계,기타법인,개인,외국인 합계,전체
"2023/05/04","4627","1","3672","1335","9635"
"2023/05/03","8377","0","6779","1074","16230"
"2023/05/02","2493","1","8123","564","11181"
"2023/04/28","10867","1","9378","564","20810"
"2023/04/27","3356","1","2407","1251","7015"
"2023/04/26","24455","2","5949","911","31317"
"2023/04/25","11164","0","3491","1078","15733"
"2023/04/24","7938","0","11796","1075","20809"
"2023/04/21","13595","0","16598","1255","31448"
"2023/04/20","9303","3750","2591","7788","23432"
"2023/04/19","5826","3751","6594","1307","17478"
"2023/04/18","16860","0","2269","915","20044"
"2023/04/17","1559","0","4001","959","6519"
"2023/04/14","6119","3258","1584","1312","12273"
"2023/04/13","4594","2","553","1177","6326"
"2023/04/12","1919","0","6692","833","9444"
"2023/04/11","5786","2","10953","1007","17748"
"2023/04/10","1073","1","17849","1187","20110"
"2023/04/07","11","0","7372","1599","8982"
"2023/04/06","252","0","3084","1059","4395"
"2023/04/05","2370","1","18451","1152","21974"
"2023/04/04","4","0","38200","8380","46584"
"2023/04/03","888","0","11129","707","12724"
"2023/03/31","7653","22423","18381","717","49174"
"2023/03/30","422","0","7436","169","8027"
"2023/03/29","0","54","5100","370","5524"
"2023/03/28","214","71","4352","666","5303"
"2023/03/27","1322","0","6606","517","8445"
"2023/03/24","2229","0","2167","601","4997"
"2023/03/23","0","0","5593","691","6284"
"2023/03/22","650","315","7622","510","9097"
"2023/03/21","6502","0","546","705","7753"
"2023/03/20","1560","21","378","588","2547"
"2023/03/17","1054","106","5591","856","7607"
"2023/03/16","57","0","3948","660","4665"
"2023/03/15","516","100","3433","1022","5071"
"2023/03/14","2006","1","8401","1168","11576"
"2023/03/13","3662","0","3070","1059","7791"
"2023/03/10","0","600","7226","958","8784"
"2023/03/09","250","0","2274","386","2910"
"2023/03/08","1373","0","3684","1000","6057"
"2023/03/07","5708","4293","10415","1002","21418"
"2023/03/06","450","0","7247","462","8159"
"2023/03/03","9628","1","6448","1142","17219"
"2023/03/02","1425","0","4199","480","6104"
"2023/02/28","4619","0","9684","473","14776"
"2023/02/27","5270","0","3244","800","9314"
"2023/02/24","200","192","5231","305","5928"
"2023/02/23","5697","0","5779","495","11971"
"2023/02/22","2654","0","14679","791","18124"
"2023/02/21","2949","0","4656","937","8542"
"2023/02/20","1790","2","9826","870","12488"
"2023/02/17","3668","0","1386","742","5796"
"2023/02/16","3500","0","4415","518","8433"
"2023/02/15","3493","0","4347","3815","11655"
"2023/02/14","4313","2000","8859","1014","16186"
"2023/02/13","3442","0","5838","967","10247"
"2023/02/10","1543","0","5940","115","7598"
"2023/02/09","750","0","22784","21","23555"
"2023/02/08","5086","0","18529","45","23660"
"2023/02/07","6879","0","874","437","8190"
"2023/02/06","1301","299","15886","791","18277"
"2023/02/03","7807","20","35482","811","44120"
"2023/02/02","193","2775","13706","798","17472"
"2023/02/01","360","0","13121","1793","15274"
"2023/01/31","474","500","11061","571","12606"
"2023/01/30","657","566","6643","2417","10283"
"2023/01/27","102","558","11857","3","12520"
"2023/01/26","5193","1877","14422","235","21727"
"2023/01/25","600","1875","14414","509","17398"
"2023/01/20","28623","1876","10342","365","41206"
"2023/01/19","926","0","5619","456","7001"
"2023/01/18","1470","1","13269","22","14762"
"2023/01/17","1318","2","11597","201","13118"
"2023/01/16","1","1876","11436","2","13315"
"2023/01/13","2697","2","7869","0","10568"
"2023/01/12","2422","0","11629","49","14100"
"2023/01/11","2034","0","3372","2","5408"
"2023/01/10","2071","2","16007","8","18088"
"2023/01/09","1901","0","25060","97","27058"
"2023/01/06","623","1","22090","48","22762"
"2023/01/05","7013","1","14214","2167","23395"
"2023/01/04","2658","2","8550","1553","12763"
"2023/01/03","2","0","7643","2168","9813"
"2023/01/02","120","2","9627","3608","13357"
"2022/12/29","1177","0","25550","4501","31228"
"2022/12/28","1077","0","33678","4926","39681"
"2022/12/27","948","299","6059","2013","9319"
"2022/12/26","8","1","11175","1368","12552"
"2022/12/23","16011","0","8730","287","25028"
"2022/12/22","1554","4","13824","0","15382"
"2022/12/21","5555","3","13118","0","18676"
"2022/12/20","2579","10","46607","7175","56371"
"2022/12/19","17163","768","45172","15537","78640"
"2022/12/16","5493","1","8000","3358","16852"
"2022/12/15","2511","0","4799","1419","8729"
"2022/12/14","4624","0","7040","177","11841"
"2022/12/13","1837","0","6805","4957","13599"
"2022/12/12","3051","2","9300","1383","13736"
"2022/12/09","3355","0","6782","1","10138"
"2022/12/08","1596","0","26660","1826","30082"
"2022/12/07","1250","0","13982","4635","19867"
"2022/12/06","16102","425","11715","6108","34350"
"2022/12/05","3559","786","8796","316","13457"
"2022/12/02","1954","3058","30218","583","35813"
"2022/12/01","10692","5001","73082","2164","90939"
"2022/11/30","11981","0","17167","1660","30808"
"2022/11/29","18147","0","27816","289","46252"
"2022/11/28","29337","140","18125","2042","49644"
"2022/11/25","28648","0","55580","1303","85531"
"2022/11/24","4484","0","6167","807","11458"
"2022/11/23","3647","0","2846","2049","8542"
"2022/11/22","15969","0","9554","1363","26886"
"2022/11/21","4573","1","24477","3962","33013"
"2022/11/18","7205","0","3966","2812","13983"
"2022/11/17","10234","0","10187","1780","22201"
"2022/11/16","21930","0","17541","2692","42163"
"2022/11/15","4959","0","10128","7828","22915"
"2022/11/14","20327","2003","17410","870","40610"
"2022/11/11","30705","4923","39851","3118","78597"
"2022/11/10","14004","3","3138","8156","25301"
"2022/11/09","19600","1","10309","385","30295"
"2022/11/08","15718","3","7935","1648","25304"
"2022/11/07","22026","2","3014","3718","28760"
"2022/11/04","12017","34","11540","12258","35849"
"2022/11/03","12815","2","2035","2358","17210"
"2022/11/02","7128","2","6630","2119","15879"
"2022/11/01","21415","4","5171","2622","29212"
"2022/10/31","29233","401","20476","3297","53407"
"2022/10/28","14590","603","16796","13367","45356"
"2022/10/27","62955","1006","13097","3613","80671"
"2022/10/26","75904","0","13210","20295","109409"
"2022/10/25","23587","0","8921","8147","40655"
"2022/10/24","64699","0","7778","7854","80331"
"2022/10/21","22050","0","24835","12495","59380"
"2022/10/20","88582","0","17361","19793","125736"
"2022/10/19","30012","0","18182","9600","57794"
"2022/10/18","28596","2941","48395","4232","84164"
"2022/10/17","11657","25","32309","4456","48447"
"2022/10/14","23362","50","17379","648","41439"
"2022/10/13","19854","0","19711","4054","43619"
"2022/10/12","13274","457","6447","2493","22671"
"2022/10/11","29756","0","63036","4586","97378"
"2022/10/07","7309","0","16382","3504","27195"
"2022/10/06","14491","250","22482","4171","41394"
"2022/10/05","21557","0","46469","6342","74368"
"2022/10/04","7556","21030","35854","807","65247"
"2022/09/30","6015","1","19561","1803","27380"
"2022/09/29","5810","1","10963","4613","21387"
"2022/09/28","39510","0","6039","8852","54401"
"2022/09/27","19754","0","35654","3321","58729"
"2022/09/26","15940","7","47242","4033","67222"
"2022/09/23","7455","0","16182","2772","26409"
"2022/09/22","13023","9","6228","2313","21573"
"2022/09/21","5315","1","2081","806","8203"
"2022/09/20","8231","1","7015","1033","16280"
"2022/09/19","17406","0","4494","1791","23691"
"2022/09/16","5008","0","10781","1910","17699"
"2022/09/15","13623","0","3581","735","17939"
"2022/09/14","21438","0","3158","756","25352"
"2022/09/13","15633","13083","16064","912","45692"
"2022/09/08","12613","0","6781","1699","21093"
"2022/09/07","15274","0","2170","4126","21570"
"2022/09/06","7212","0","2107","1009","10328"
"2022/09/05","11137","0","3889","1606","16632"
"2022/09/02","11702","1","15650","2287","29640"
"2022/09/01","14620","0","4716","6473","25809"
"2022/08/31","2852","0","14563","771","18186"
"2022/08/30","19173","4","6562","6849","32588"
"2022/08/29","7793","0","20660","4384","32837"
"2022/08/26","2840","2","16629","5491","24962"
"2022/08/25","4963","0","29058","1567","35588"
"2022/08/24","3015","7","22671","1410","27103"
"2022/08/23","887","0","33255","4670","38812"
"2022/08/22","91206","1","13852","3622","108681"
"2022/08/19","9952","2477","21359","5977","39765"
"2022/08/18","56390","0","11172","6838","74400"
"2022/08/17","13088","802","18130","4764","36784"
"2022/08/16","7992","1","3618","2691","14302"
"2022/08/12","19637","1","7164","764","27566"
"2022/08/11","1351","2","3762","820","5935"
"2022/08/10","3894","30638","8844","8122","51498"
"2022/08/09","11936","3301","5859","2802","23898"
"2022/08/08","8292","1","29306","3160","40759"
"2022/08/05","10974","1","21989","5813","38777"
"2022/08/04","20175","32154","48432","16241","117002"
"2022/08/03","30197","24623","37381","8553","100754"
"2022/08/02","11614","9455","36293","13471","70833"
"2022/08/01","11445","1332","10657","7742","31176"
"2022/07/29","8900","71","23006","26455","58432"
"2022/07/28","15332","1005","86573","2997","105907"
"2022/07/27","57921","0","21686","11024","90631"
"2022/07/26","27760","3","26338","10878","64979"
"2022/07/25","32053",,"60712","1500","94265"
"2022/07/22","80377","1717","28069","10785","120948"
"2022/07/21","32428","885","40728","9467","83508"
"2022/07/20","20321","0","13833","2491","36645"
"2022/07/19","27954","1","20706","8935","57596"
"2022/07/18","12778","1500","184","4156","18618"
"2022/07/15","10373","0","21420","12534","44327"
"2022/07/14","10000",,"19366","8760","38126"
"2022/07/13","2858","0","4308","3353","10519"
"2022/07/12","15050","0","39879","7020","61949"
"2022/07/11","17319","0","8989","12047","38355"
"2022/07/08","10141","0","3955","3551","17647"
"2022/07/07","16005","0","20478","3830","40313"
"2022/07/06","25046","0","13568","6595","45209"
"2022/07/05","17776","0","29052","3675","50503"
"2022/07/04","27615","0","36344","8986","72945"
"2022/07/01","32920","100","17709","9390","60119"
"2022/06/30","12143","0","8106","13446","33695"
"2022/06/29","31160","1","15867","3347","50375"
"2022/06/28","19584","1","47504","7118","74207"
"2022/06/27","27334","9","41646","14295","83284"
"2022/06/24","35063","3156","19207","5168","62594"
"2022/06/23","38232","720","13556","6269","58777"
"2022/06/22","51992","32877","25088","2957","112914"
"2022/06/21","25455","12165","22988","3145","63753"
"2022/06/20","23694","200","34606","5189","63689"
"2022/06/17","2136","0","55422","8306","65864"
"2022/06/16","12168","2247","28246","7405","50066"
"2022/06/15","12443","0","51004","4885","68332"
"2022/06/14","16226","0","34305","7925","58456"
"2022/06/13","5707","0","31128","3748","40583"
"2022/06/10","7118","0","12482","3306","22906"
"2022/06/09","20735","10943","4766","2834","39278"
"2022/06/08","10334","0","7811","1204","19349"
"2022/06/07","7776","3","7992","1815","17586"
"2022/06/03","1165","0","16990","1446","19601"
"2022/06/02","3496","40","10220","5250","19006"
"2022/05/31","2031","60","12650","14103","28844"
"2022/05/30","713","1","9110","2324","12148"
"2022/05/27","5829","1340","10586","4853","22608"
"2022/05/26","11113","103","29216","5869","46301"
"2022/05/25","6161","2","28977","1116","36256"
"2022/05/24","3653","0","10360","1398","15411"
"2022/05/23","3174","822","27242","4283","35521"
"2022/05/20","146","0","9989","3412","13547"
"2022/05/19","3817","0","9351","950","14118"
"2022/05/18","37133","0","38593","4895","80621"
"2022/05/17","33169","0","32704","10691","76564"
"2022/05/16","591","0","16691","1412","18694"
"2022/05/13","2686","4","28161","2269","33120"
"2022/05/12","4034","1","24857","7054","35946"
"2022/05/11","274","6","4232","5372","9884"
"2022/05/10","13796","6004","44618","4141","68559"
"2022/05/09","2324","1000","13680","1454","18458"
"2022/05/06","2792","0","13897","2","16691"
"2022/05/04","16675","1","15494","6251","38421"
"2022/05/03","6513","0","47661","4269","58443"
"2022/05/02","13685",,"14097","288","28070"
"2022/04/29","1457","0","30497","7395","39349"
"2022/04/28","31822",,"45902","6515","84239"
"2022/04/27","16211","0","23020","1744","40975"
"2022/04/26","15017","749","26231","1269","43266"
"2022/04/25","24744","3001","32435","939","61119"
"2022/04/22","17147","0","27398","1436","45981"
"2022/04/21","9429","2000","36427","426","48282"
"2022/04/20","371","517","25895","2791","29574"
"2022/04/19","10670","1","27383","3353","41407"
"2022/04/18","26087","9924","132978","18676","187665"
"2022/04/15","25084","1100","56934","1984","85102"
"2022/04/14","11704","2075","61627","279","75685"
"2022/04/13","24491","1513","66581","1534","94119"
"2022/04/12","2064","1412","30848","1319","35643"
"2022/04/11","30660","3066","9660","1456","44842"
"2022/04/08","21010","0","27324","406","48740"
"2022/04/07","3780","0","22954","4234","30968"
"2022/04/06","3496","0","51489","3480","58465"
"2022/04/05","7740","221","63098","4963","76022"
"2022/04/04","32061","0","45165","7701","84927"
"2022/04/01","5705","0","16015","11","21731"
"2022/03/31","8716","4","11909","4956","25585"
"2022/03/30","6099","31","8742","6791","21663"
"2022/03/29","10304","20","9259","0","19583"
"2022/03/28","16609","3481","12703","15","32808"
"2022/03/25","16273","19","8181","2419","26892"
"2022/03/24","4644","4000","281","2257","11182"
"2022/03/23","10257","0","21731","5867","37855"
"2022/03/22","2123","5114","9934","3393","20564"
"2022/03/21","49","0","15512","1881","17442"
"2022/03/18","3552","0","17236","5546","26334"
"2022/03/17","15433","0","3648","765","19846"
"2022/03/16","14920","1954","5801","18741","41416"
"2022/03/15","25321","886","9249","4247","39703"
"2022/03/14","34180","0","35418","1768","71366"
"2022/03/11","49579","0","14752","1178","65509"
"2022/03/10","6796","0","4755","1209","12760"
"2022/03/08","3386","0","4036","1688","9110"
"2022/03/07","17682","8707","20956","831","48176"
"2022/03/04","19052","2","9727","558","29339"
"2022/03/03","6884","0","9959","19","16862"
"2022/03/02","9587","0","13072","110","22769"
"2022/02/28","14152","1","6031","2079","22263"
"2022/02/25","2757","4","1905","422","5088"
"2022/02/24","8944","250","26302","1851","37347"
"2022/02/23","15168","8839","5982","1238","31227"
"2022/02/22","7012","0","11384","3562","21958"
"2022/02/21","6198","0","9431","3743","19372"
"2022/02/18","10178","0","14976","5348","30502"
"2022/02/17","45196","3000","6018","8931","63145"
"2022/02/16","19299","6002","27192","2982","55475"
"2022/02/15","1096","1","29201","5513","35811"
"2022/02/14","2994","1","26808","1623","31426"
"2022/02/11","10165","5504","21102","3170","39941"
"2022/02/10","32242","4322","9656","5195","51415"
"2022/02/09","32942","13066","3320","4670","53998"
"2022/02/08","18247","0","29018","1018","48283"
"2022/02/07","24520","1","35901","1899","62321"
"2022/02/04","1497","4","12702","15","14218"
"2022/02/03","1418","5032","36982","1748","45180"
"2022/01/28","585","0","14523","1620","16728"
"2022/01/27","7817","5","19080","2394","29296"
"2022/01/26","6483","10","16947","3553","26993"
"2022/01/25","45315","9","29444","8114","82882"
"2022/01/24","17399","2","29695","1950","49046"
"2022/01/21","15940",,"14524","2123","32587"
"2022/01/20","15674","3","9667","6990","32334"
"2022/01/19","11248","0","22910","1664","35822"
"2022/01/18","2196","0","58647","1460","62303"
"2022/01/17","12970","2","28256","2110","43338"
"2022/01/14","910","1","4416","46","5373"
"2022/01/13","2260","1000","20699","0","23959"
"2022/01/12","40958","0","13060","0","54018"
"2022/01/11","14844","0","5183","1367","21394"
"2022/01/10","6814","500","48035","100","55449"
"2022/01/07","1536",,"38321","0","39857"
"2022/01/06","28364","0","18727","431","47522"
"2022/01/05","36128","3","6706","0","42837"
"2022/01/04","6056","1","33805","1316","41178"
"2022/01/03","13360","6","30675","4835","48876"
"2021/12/30","22521","7","10753","4791","38072"
"2021/12/29","7995","5","24172","10906","43078"
"2021/12/28","50004","30","69836","720","120590"
"2021/12/27","24691","26","60949","275","85941"
"2021/12/24","11886","0","47414","0","59300"
"2021/12/23","3823","0","25791",,"29614"
"2021/12/22","357","0","10116","38","10511"
"2021/12/21","1406","1001","9267","814","12488"
"2021/12/20","10100","0","31242","6352","47694"
"2021/12/17","969","19000","9009","3305","32283"
"2021/12/16","15125",,"7608","3635","26368"
"2021/12/15","7929","0","2432","522","10883"
"2021/12/14","3838","0","21554","170","25562"
"2021/12/13","11062",,"112081","2586","125729"
"2021/12/10","28080","0","5663","5313","39056"
"2021/12/09","17830",,"2208","9696","29734"
"2021/12/08","1032","0","15236","3114","19382"
"2021/12/07","3410","0","14468","4868","22746"
"2021/12/06","20800","0","37443","12507","70750"
"2021/12/03","26317","3501","25729","3307","58854"
"2021/12/02","34278","4","5594","4518","44394"
"2021/12/01","46340","9","23419","991","70759"
"2021/11/30","22385","1634","32575","7461","64055"
"2021/11/29","29155","0","19977","3085","52217"
"2021/11/26","63416","228","67788","4449","135881"
"2021/11/25","13429","0","39073","510","53012"
"2021/11/24","12554","0","23119","0","35673"
"2021/11/23","21410","5000","36939","3099","66448"
"2021/11/22","12200","0","8297","5040","25537"
"2021/11/19","1380","142","23979",,"25501"
"2021/11/18","4930","4654","7201","700","17485"
"2021/11/17","22778","2094","9168","2852","36892"
"2021/11/16","18358","6003","6121","1821","32303"
"2021/11/15","24625","3","13771","1149","39548"
"2021/11/12","1800","0","7183","2","8985"
"2021/11/11","17393",,"10896","0","28289"
"2021/11/10","12941","0","3946","478","17365"
"2021/11/09","23694",,"8094","261","32049"
"2021/11/08","6738","2","6413","0","13153"
"2021/11/05","15364","120","9433","0","24917"
"2021/11/04","15307","2897","33583","2787","54574"
"2021/11/03","7083","0","8344","2054","17481"
"2021/11/02","4084","0","24681","7003","35768"
"2021/11/01","17101","0","23177","1699","41977"
"2021/10/29","26075","0","8017","511","34603"
"2021/10/28","21239","6000","14899","9971","52109"
"2021/10/27","18319","0","5653","6219","30191"
"2021/10/26","13662","0","13451","3082","30195"
"2021/10/25","24348","0","9106","11413","44867"
"2021/10/22","26518","0","24403","6637","57558"
"2021/10/21","19500","0","17555","5557","42612"
"2021/10/20","70344","0","21990","14629","106963"
"2021/10/19","11648","0","50150","11808","73606"
"2021/10/18","33430","8311","66670","5444","113855"
"2021/10/15","23711","0","37045","11487","72243"
"2021/10/14","19658","4000","29562","2986","56206"
"2021/10/13","13156","25173","40242","4248","82819"
"2021/10/12","4672","0","126324","14108","145104"
"2021/10/08","19270","0","21642","2191","43103"
"2021/10/07","9593","0","25381","3901","38875"
"2021/10/06","15064","0","50116","7880","73060"
"2021/10/05","15690","3505","19900","12661","51756"
"2021/10/01","11603","1036","74692","2281","89612"
"2021/09/30","5526","0","35731","9446","50703"
"2021/09/29","48947","0","120402","5163","174512"
"2021/09/28","41640","0","48812","2349","92801"
"2021/09/27","24515","0","37224","0","61739"
"2021/09/24","14314","0","23459","105","37878"
"2021/09/23","11867","0","36263","7900","56030"
"2021/09/17","7822","0","25042","568","33432"
"2021/09/16","2310","0","8871","0","11181"
"2021/09/15","7216","0","66241","0","73457"
"2021/09/14","18045","0","73945","742","92732"
"2021/09/13","9482","0","20321","69","29872"
"2021/09/10","1210","0","16044","0","17254"
"2021/09/09","14545","0","36835","0","51380"
"2021/09/08","14147","0","19827","239","34213"
"2021/09/07","5000","0","15528","0","20528"
"2021/09/06","10053","0","9255","0","19308"
"2021/09/03","7434","0","15934","0","23368"
"2021/09/02","6841","1000","38532","1377","47750"
"2021/09/01","9352","750","34064","5585","49751"
"2021/08/31","394","0","29940","1066","31400"
"2021/08/30","11624","0","14391","5225","31240"
"2021/08/27","2502","0","34217","4881","41600"
"2021/08/26","3054","0","21204","4447","28705"
"2021/08/25","6461","0","30428","174","37063"
"2021/08/24","10356","6000","24870","998","42224"
"2021/08/23","28813","0","14218","0","43031"
"2021/08/20","16415","7336","60437","10679","94867"
"2021/08/19","39725","0","55200","0","94925"
"2021/08/18","25860","0","25883","805","52548"
"2021/08/17","12617","0","19962","1067","33646"
"2021/08/13","30180","0","58518","3927","92625"
"2021/08/12","12716","0","30473","0","43189"
"2021/08/11","33095","0","28500","202","61797"
"2021/08/10","24486","15000","9199","4249","52934"
"2021/08/09","24000",,"14454","1834","40288"
"2021/08/06","761","0","20227","0","20988"
"2021/08/05","15900","0","5617","0","21517"
"2021/08/04","4696","0","12600","468","17764"
"2021/08/03","17171","0","20552","877","38600"
"2021/08/02","2684","35","31084","2361","36164"
"2021/07/30","6782","462","24742","265","32251"
"2021/07/29","1101","0","9516","0","10617"
"2021/07/28","2622","0","4655","0","7277"
"2021/07/27","1329",,"17808","1486","20623"
"2021/07/26","5543",,"22059","638","28240"
"2021/07/23","1129",,"27531","4156","32816"
"2021/07/22","19855",,"5759","0","25614"
"2021/07/21","8871",,"27987","0","36858"
"2021/07/20","1000",,"21466","3002","25468"
"2021/07/19","2392","3000","22667","0","28059"
"2021/07/16","17852","0","49997","0","67849"
"2021/07/15","8201",,"47166","0","55367"
"2021/07/14","52776",,"15806","359","68941"
"2021/07/13","68339","0","18537","347","87223"
"2021/07/12","51290",,"20879","7871","80040"
"2021/07/09","65319","0","30128","5617","101064"
"2021/07/08","53060",,"18676","5124","76860"
"2021/07/07","72186","0","8145","6855","87186"
"2021/07/06","72662","0","49564","0","122226"
"2021/07/05","59389","346","44680","0","104415"
"2021/07/02","63436",,"19440","202","83078"
"2021/07/01","93985","3463","108131","209","205788"
"2021/06/30","101252","0","24452","10762","136466"
"2021/06/29","58234","12000","40607","7071","117912"
"2021/06/28","87275","0","60801","3115","151191"
"2021/06/25","76232","0","34619","6908","117759"
"2021/06/24","76067",,"37671","0","113738"
"2021/06/23","82346","17315","25219","0","124880"
"2021/06/22","66372","0","25643","3310","95325"
"2021/06/21","75789","0","34238","1563","111590"
"2021/06/18","60807",,"53687","559","115053"
"2021/06/17","74276","4000","25588","1952","105816"
"2021/06/16","69968","0","33572","5396","108936"
"2021/06/15","77431","0","43288","2897","123616"
"2021/06/14","63342","0","13774","6116","83232"
"2021/06/11","67139","0","12881","407","80427"
"2021/06/10","69586","0","39194","6831","115611"
"2021/06/09","81261",,"17328","241","98830"
"2021/06/08","70118","0","28200","9418","107736"
"2021/06/07","76923","35000","14192","3041","129156"
"2021/06/04","49711","27211","29924","17495","124341"
"2021/06/03","35435","0","97244","14581","147260"
"2021/06/02","53756","0","126465","4494","184715"
"2021/06/01","63145","5000","68878","13065","150088"
"2021/05/31","44474","0","80102","2821","127397"
"2021/05/28","21018","0","33964","5674","60656"
"2021/05/27","22338","152","114365","15848","152703"
"2021/05/26","17419","0","14083","13220","44722"
"2021/05/25","21293","0","105491","3407","130191"
"2021/05/24","5350","0","44621","1878","51849"
"2021/05/21","1777","0","38018","604","40399"
"2021/05/20","8539","18349","25944","1361","54193"
"2021/05/18","6279","0","40826","2506","49611"
"2021/05/17","3522","0","50103","3953","57578"
"2021/05/14","9077","0","34140","6242","49459"
"2021/05/13","1320","0","39949","2109","43378"
"2021/05/12","5184","0","56391","4838","66413"
"2021/05/11","3759","0","61326","7047","72132"
"2021/05/10","1280","0","71251","731","73262"
"2021/05/07","3271","0","59651","4978","67900"
"2021/05/06","4834",,"38376","16106","59316"
"2021/05/04","13189","0","66152","2198","81539"
"2021/05/03","8170",,"33779","495","42444"
"2021/04/30","377","0","18957","3232","22566"
"2021/04/29","1750","0","23088","25","24863"
"2021/04/28","6470","0","23546","3094","33110"
"2021/04/27","2404","7814","36791","4338","51347"
"2021/04/26","13608","0","72987","3435","90030"
"2021/04/23","12117","0","15527","0","27644"
"2021/04/22","12510","50000","27336","4433","94279"
"2021/04/21","3466","0","32887","4050","40403"
"2021/04/20","24980",,"62313","4677","91970"
"2021/04/19","7404",,"83236","453","91093"
"2021/04/16","1463","0","50892","10868","63223"
"2021/04/15","2906","0","59215","0","62121"
"2021/04/14","99","0","44837","1809","46745"
"2021/04/13","2643","7814","33823","1623","45903"
"2021/04/12","1635",,"59866","2884","64385"
"2021/04/09","30","900","30459","2988","34377"
"2021/04/08","1382",,"15312","1124","17818"
"2021/04/07","1100","0","20030","907","22037"
"2021/04/06","625",,"76837","3495","80957"
"2021/04/05","24549","0","63368","1138","89055"
"2021/04/02","2610","3143","49708","5001","60462"
"2021/04/01","2088","12491","34155","615","49349"
"2021/03/31","2552","0","24788","524","27864"
"2021/03/30","5339",,"23466","2533","31338"
"2021/03/29","5200","62500","83728","6652","158080"
"2021/03/26","18221","500","66228","2468","87417"
"2021/03/25","4533","0","24527","2189","31249"
"2021/03/24","7463","0","14432","231","22126"
"2021/03/23","810","0","14739","1734","17283"
"2021/03/22","58057","0","16474","3190","77721"
"2021/03/19","2351","378","19643","196","22568"
"2021/03/18","300","622","28134","1349","30405"
"2021/03/17","552",,"21089","1521","23162"
"2021/03/16","1100","1851","13341","3296","19588"
"2021/03/15","378","0","20669","9031","30078"
"2021/03/12","2136",,"17150","9320","28606"
"2021/03/11","277",,"8662","5981","14920"
"2021/03/10","44167","0","13410","2339","59916"
"2021/03/09","32178","300","32580","1938","66996"
"2021/03/08","32872","0","37496","1741","72109"
"2021/03/05","43184","0","15708","4759","63651"
"2021/03/04","4586",,"11318","24","15928"
"2021/03/03","19507",,"6986","4112","30605"
"2021/03/02","1501","0","38983","2462","42946"
"2021/02/26","7236","2000","14515","2458","26209"
"2021/02/25","9304","2135","8834","3240","23513"
"2021/02/24","57764",,"18435","1226","77425"
"2021/02/23","49400","0","32870","710","82980"
"2021/02/22","49500","0","104431","1727","155658"
"2021/02/19","52200","0","154694","3489","210383"
"2021/02/18","65631","0","28907","3383","97921"
"2021/02/17","69601","0","22569","1019","93189"
"2021/02/16","81401",,"35908","1024","118333"
"2021/02/15","39600",,"40089","627","80316"
"2021/02/10","6662","0","32166","5700","44528"
"2021/02/09","1000",,"24320","1422","26742"
"2021/02/08","10836","0","9125","0","19961"
"2021/02/05","7390","0","80227","2791","90408"
"2021/02/04","4526","0","21649","0","26175"
"2021/02/03","6873","0","26524",,"33397"
"2021/02/02","14736","0","30291","589","45616"
"2021/02/01","10404",,"12931","0","23335"
"2021/01/29","377",,"26042","224","26643"
"2021/01/28","3007","0","29400","1641","34048"
"2021/01/27","2000",,"16367","1012","19379"
"2021/01/26","3070","0","19842","1648","24560"
"2021/01/25","7180","0","19643","0","26823"
"2021/01/22","9932","0","31653","10684","52269"
"2021/01/21","1202","0","100530","5272","107004"
"2021/01/20","2795","0","27995","854","31644"
"2021/01/19","24083",,"53846","300","78229"
"2021/01/18","19357",,"19246","2703","41306"
"2021/01/15","1724",,"18035","2014","21773"
"2021/01/14","13431",,"28474","957","42862"
"2021/01/13","240","0","14655","549","15444"
"2021/01/12","24386","0","29041","1072","54499"
"2021/01/11","9333","0","150520","11896","171749"
"2021/01/08","7664","0","106984","6959","121607"
"2021/01/07","5583","0","73440","681","79704"
"2021/01/06","45922","20000","40089","5071","111082"
"2021/01/05","6440","80000","99200","11976","197616"
"2021/01/04","880","0","127509","17575","145964"
"2020/12/30","106","3713","43328","8014","55161"
"2020/12/29","30600","2837","99930","3860","137227"
"2020/12/28","57825","0","85728","3877","147430"
"2020/12/24","5","0","108565","2773","111343"
"2020/12/23","10063","0","42922","7145","60130"
"2020/12/22","36964","0","43206","2025","82195"
"2020/12/21","19626","0","31348","0","50974"
"2020/12/18","27049","0","36921","18","63988"
"2020/12/17","3513","0","41924","776","46213"
"2020/12/16","794","0","21049","1531","23374"
"2020/12/15","206","0","24387","0","24593"
"2020/12/14","25053","90983","49546","15263","180845"
"2020/12/11","30247","40000","7484","756","78487"
"2020/12/10","25158","20000","30333","7807","83298"
"2020/12/09","21777","30","26341","4457","52605"
"2020/12/08","25683","131","9890","1043","36747"
"2020/12/07","41007","0","27593","1013","69613"
"2020/12/04","18095","0","51087","1307","70489"
"2020/12/03","21515",,"66112","27","87654"
"2020/12/02","34109",,"32755","0","66864"
"2020/12/01","37149","0","30072","2758","69979"
"2020/11/30","27067","0","56061","1993","85121"
"2020/11/27","12425","0","42494","10043","64962"
"2020/11/26","23229","10000","19708","1352","54289"
"2020/11/25","20443","0","31443","3","51889"
"2020/11/24","67659",,"45145","11937","124741"
"2020/11/23","13662","0","55295","9471","78428"
"2020/11/20","71382","0","31692","13529","116603"
"2020/11/19","78105","39","15957","3079","97180"
"2020/11/18","57667","0","19318","1182","78167"
"2020/11/17","21064","0","53980","2062","77106"
"2020/11/16","26445","0","27530","4712","58687"
"2020/11/13","49684","0","36297","13","85994"
"2020/11/12","73877","0","16212","63","90152"
"2020/11/11","34899","0","76437","10008","121344"
"2020/11/10","25305","0","26379","7296","58980"
"2020/11/09","21222","130","63648","12189","97189"
"2020/11/06","21266","0","37683","1862","60811"
"2020/11/05","39006",,"55333","5333","99672"
"2020/11/04","50581","0","35972","13027","99580"
"2020/11/03","63202","256","35547","18899","117904"
"2020/11/02","67692","212","84447","31925","184276"
"2020/10/30","27716","13362","85402","11556","138036"
"2020/10/29","21708","26338","75368","3261","126675"
"2020/10/28","15425","17136","73197","28088","133846"
"2020/10/27","7708","44564","77318","24738","154328"
"2020/10/26","17633","39","145785","88732","252189"
"2020/10/23","46160","0","209499","10628","266287"
"2020/10/22","15672","0","114774","6753","137199"
"2020/10/21","11056","0","43209","2780","57045"
"2020/10/20","14565","0","42873","9587","67025"
"2020/10/19","27584","0","96329","8492","132405"
"2020/10/16","20356",,"83759","6728","110843"
"2020/10/15","49572","3046","85600","3666","141884"
"2020/10/14","27193","36260","62959","10201","136613"
"2020/10/13","11811","2000","27264","6613","47688"
"2020/10/12","24175",,"49415","35611","109201"
"2020/10/08","53918","0","174633","23865","252416"
"2020/10/07","62575","500","120288","31211","214574"
"2020/10/06","69828","15333","94976","11943","192080"
"2020/10/05","59919",,"66020","3691","129630"
"2020/09/29","15694",,"65469","1720","82883"
"2020/09/28","24328","0","30208","2358","56894"
"2020/09/25","17132","0","41854","12150","71136"
"2020/09/24","55385","0","87081","2019","144485"
"2020/09/23","26615","0","32745","5585","64945"
"2020/09/22","30080","0","26252","4531","60863"
"2020/09/21","5000","0","75001","2067","82068"
"2020/09/18","10378","0","38415","3088","51881"
"2020/09/17","26662","260","154548","18262","199732"
"2020/09/16","22858","230","69956","823","93867"
"2020/09/15","31787","0","21411","3520","56718"
"2020/09/14","58890","2000","28652","2619","92161"
"2020/09/11","45398","0","34998","2456","82852"
"2020/09/10","32340","0","19109","4996","56445"
"2020/09/09","54500","0","39647","9842","103989"
"2020/09/08","42914","0","39386","2263","84563"
"2020/09/07","48314","0","52782","1090","102186"
"2020/09/04","18656","0","99462","300","118418"
"2020/09/03","32914","0","20306","943","54163"
"2020/09/02","16584",,"28256","5200","50040"
"2020/09/01","45199","0","36556","438","82193"
"2020/08/31","41495","0","110866","962","153323"
"2020/08/28","28194","0","26721","0","54915"
"2020/08/27","28686","0","94464","0","123150"
"2020/08/26","40955","0","55538","0","96493"
"2020/08/25","13470","0","41811","0","55281"
"2020/08/24","15500","0","79712","2170","97382"
"2020/08/21","24465","0","38701","361","63527"
"2020/08/20","8786","0","89719","4321","102826"
"2020/08/19","19712","0","47268","0","66980"
"2020/08/18","47985","0","62113","0","110098"
"2020/08/14","50572","400","78320","0","129292"
"2020/08/13","12799","0","77344","10342","100485"
"2020/08/12","75489","1000","300393","33087","409969"
"2020/08/11","56089","1000","249512","16974","323575"
"2020/08/10","13572","4700","309971","642","328885"
"2020/08/07","21612","0","189754","1640","213006"
"2020/08/06","99553","1000","364999","2224","467776"
"2020/08/05","643318","17275","1694004","2270","2356867"