일자,기관 합계,기타법인,개인,외국인 합계,전체
"2023/05/04","122064","1000","121143","5990","250197"
"2023/05/03","134972","8000","101691","28167","272830"
"2023/05/02","90750","142","138646","98283","327821"
"2023/04/28","65677","18000","142839","27586","254102"
"2023/04/27","150967","0","71395","18748","241110"
"2023/04/26","141361","1000","76292","68008","286661"
"2023/04/25","168460","0","73444","35944","277848"
"2023/04/24","151628","15000","107004","53653","327285"
"2023/04/21","308070","0","94116","17171","419357"
"2023/04/20","180516","4209","111800","6915","303440"
"2023/04/19","144534","4209","158501","25183","332427"
"2023/04/18","165730","22818","132732","22362","343642"
"2023/04/17","81307","0","143483","21844","246634"
"2023/04/14","132029","0","412599","11603","556231"
"2023/04/13","112075","22700","135699","21865","292339"
"2023/04/12","48182","50102","78408","4435","181127"
"2023/04/11","102069","48144","88685","11505","250403"
"2023/04/10","48930","4400","184756","18423","256509"
"2023/04/07","60251","0","28445","24172","112868"
"2023/04/06","35080","1000","96240","36324","168644"
"2023/04/05","78857","0","128604","19953","227414"
"2023/04/04","53752","4","131959","20572","206287"
"2023/04/03","59407","2750","159637","18760","240554"
"2023/03/31","49873","18579","194823","42497","305772"
"2023/03/30","36784","0","135296","30100","202180"
"2023/03/29","55995","1","114157","6761","176914"
"2023/03/28","19012","13021","179196","27683","238912"
"2023/03/27","124992","22038","406941","32445","586416"
"2023/03/24","33119","0","134265","14900","182284"
"2023/03/23","44339","0","181533","46929","272801"
"2023/03/22","114007","0","102760","84438","301205"
"2023/03/21","41993","0","181520","68859","292372"
"2023/03/20","66664","0","117575","17374","201613"
"2023/03/17","7454","5001","155504","165510","333469"
"2023/03/16","17705","1000","116279","7828","142812"
"2023/03/15","41298","11950","128259","51317","232824"
"2023/03/14","75549","9476","196732","55773","337530"
"2023/03/13","41919","18079","224699","59467","344164"
"2023/03/10","104616","47217","163220","42110","357163"
"2023/03/09","11556","89450","80419","956","182381"
"2023/03/08","40199","0","147999","11546","199744"
"2023/03/07","145753","9444","119728","10863","285788"
"2023/03/06","90244","0","146046","9298","245588"
"2023/03/03","100239","0","54395","7631","162265"
"2023/03/02","207151","51698","70374","24787","354010"
"2023/02/28","201809","2001","65017","19710","288537"
"2023/02/27","66575","0","165491","9128","241194"
"2023/02/24","49494","0","74727","8654","132875"
"2023/02/23","58475","2","72000","46961","177438"
"2023/02/22","31327","10000","58102","9652","109081"
"2023/02/21","46721","447","65959","19103","132230"
"2023/02/20","30729","47954","123214","13480","215377"
"2023/02/17","38678","2","84573","6886","130139"
"2023/02/16","82948","2","108442","42492","233884"
"2023/02/15","55987","1102","89444","21727","168260"
"2023/02/14","70766","25777","89996","47181","233720"
"2023/02/13","60358","18108","197277","59131","334874"
"2023/02/10","29044","10019","88136","10646","137845"
"2023/02/09","17994","3000","80275","25523","126792"
"2023/02/08","29351","1099","92679","10292","133421"
"2023/02/07","74034","3001","46714","51874","175623"
"2023/02/06","58873","0","134311","40210","233394"
"2023/02/03","28792","76618","225022","55238","385670"
"2023/02/02","67774","2651","166878","43661","280964"
"2023/02/01","99758","6177","119625","26772","252332"
"2023/01/31","105958","800","118373","166927","392058"
"2023/01/30","163124","15000","77198","54615","309937"
"2023/01/27","293918","2","173292","27841","495053"
"2023/01/26","147126","2619","272390","28511","450646"
"2023/01/25","65051","15180","436162","47823","564216"
"2023/01/20","41166","19131","216952","9687","286936"
"2023/01/19","38437","55165","174176","18483","286261"
"2023/01/18","72503","5000","205774","18634","301911"
"2023/01/17","85062","3","173074","33270","291409"
"2023/01/16","144348","12102","290123","16361","462934"
"2023/01/13","102109","1782","248726","7118","359735"
"2023/01/12","70062","1001","188167","5073","264303"
"2023/01/11","113607","0","99478","29216","242301"
"2023/01/10","76113","45502","153978","42423","318016"
"2023/01/09","143049","3","123106","66604","332762"
"2023/01/06","64410","32071","152941","57199","306621"
"2023/01/05","58569","2","93398","38420","190389"
"2023/01/04","32543","0","85740","38650","156933"
"2023/01/03","37040","20001","134244","62682","253967"
"2023/01/02","22579","1","140459","16598","179637"
"2022/12/29","49424","2","61708","89542","200676"
"2022/12/28","160389","2","250295","182019","592705"
"2022/12/27","183108","1","599601","19529","802239"
"2022/12/26","279287","1310","335847","35346","651790"
"2022/12/23","57388","26504","213687","13081","310660"
"2022/12/22","217445","51273","255005","5921","529644"
"2022/12/21","155175","49070","191374","27525","423144"
"2022/12/20","68073","9","338800","55180","462062"
"2022/12/19","55301","30459","142026","37489","265275"
"2022/12/16","372468","5303","87604","55430","520805"
"2022/12/15","63921","5302","172785","49681","291689"
"2022/12/14","322832","5","41739","9752","374328"
"2022/12/13","54227","4002","140196","28496","226921"
"2022/12/12","103883","1","73362","545","177791"
"2022/12/09","110287","1","58001","39708","207997"
"2022/12/08","26577","1","92861","40629","160068"
"2022/12/07","53062","17730","79527","7168","157487"
"2022/12/06","44163","4461","182006","37288","267918"
"2022/12/05","31547","0","110596","45978","188121"
"2022/12/02","19511","1","121907","48404","189823"
"2022/12/01","55379","33760","299645","31209","419993"
"2022/11/30","63441","4940","100498","47163","216042"
"2022/11/29","41023","0","35449","27939","104411"
"2022/11/28","75193","30000","138129","40774","284096"
"2022/11/25","85359","1001","68976","22391","177727"
"2022/11/24","122060","0","51994","21972","196026"
"2022/11/23","104981","0","48318","25911","179210"
"2022/11/22","122263","0","53662","41534","217459"
"2022/11/21","182626","1","45722","41983","270332"
"2022/11/18","65411","0","113728","74568","253707"
"2022/11/17","87051","0","47293","61236","195580"
"2022/11/16","90800","22300","104993","58680","276773"
"2022/11/15","115341","1","39676","80561","235579"
"2022/11/14","70975","1240","185601","71085","328901"
"2022/11/11","135456","16966","497228","33580","683230"
"2022/11/10","80128","0","105096","31999","217223"
"2022/11/09","132907","0","71546","22733","227186"
"2022/11/08","265850","0","74806","48483","389139"
"2022/11/07","129694","87065","60819","41562","319140"
"2022/11/04","106197","1439","183587","64587","355810"
"2022/11/03","235127","0","108298","91314","434739"
"2022/11/02","380779","24599","149583","61560","616521"
"2022/11/01","198447","19484","121391","58215","397537"
"2022/10/31","270810","7515","263228","38993","580546"
"2022/10/28","184509","3012","139694","43580","370795"
"2022/10/27","338944","6102","271996","33699","650741"
"2022/10/26","157050","9224","215071","38224","419569"
"2022/10/25","164954","17381","141172","30767","354274"
"2022/10/24","328114","4197","169264","48441","550016"
"2022/10/21","327108","6937","395717","112314","842076"
"2022/10/20","393934","16466","466934","102113","979447"
"2022/10/19","678102","10176","190087","52004","930369"
"2022/10/18","519797","95430","227656","65659","908542"
"2022/10/17","405332","15246","312197","199195","931970"
"2022/10/14","238900","914","98399","68350","406563"
"2022/10/13","260222","141000","441386","68934","911542"
"2022/10/12","229831","709","80558","52311","363409"
"2022/10/11","138029","0","169298","95020","402347"
"2022/10/07","295524","0","70253","33780","399557"
"2022/10/06","261705","0","179186","59599","500490"
"2022/10/05","204677","0","81225","36304","322206"
"2022/10/04","248259","1389","103188","46100","398936"
"2022/09/30","393114","36601","238432","103186","771333"
"2022/09/29","205958","8000","51555","78112","343625"
"2022/09/28","427574","11202","303648","121118","863542"
"2022/09/27","84699","20444","187973","105350","398466"
"2022/09/26","220130","504","183222","193988","597844"
"2022/09/23","166128","129431","302162","133798","731519"
"2022/09/22","58468","25186","120136","198664","402454"
"2022/09/21","113593","2","81456","169207","364258"
"2022/09/20","79490","25008","59814","164665","328977"
"2022/09/19","138040","5001","243991","197950","584982"
"2022/09/16","893566","345691","910881","3291400","5441538"
"2022/09/15","364252","73800","595947","268696","1302695"
"2022/09/14","349340","197017","918620","172775","1637752"
"2022/09/13","330517","43003","961879","478665","1814064"
"2022/09/08","760233","243514","1779025","393870","3176642"
"2022/09/07","115066","11183","198532","59406","384187"
"2022/09/06","25414","8661","99041","42298","175414"
"2022/09/05","90918","2500","169685","93795","356898"
"2022/09/02","98665","373","151812","154092","404942"
"2022/09/01","198150","4500","216456","149937","569043"
"2022/08/31","70387","0","207953","74389","352729"
"2022/08/30","213335","47003","91226","36257","387821"
"2022/08/29","110656","4800","170827","73578","359861"
"2022/08/26","10402","501","126610","39867","177380"
"2022/08/25","46323","0","233519","54532","334374"
"2022/08/24","59369","2133","191919","123894","377315"
"2022/08/23","49198","15754","248955","185988","499895"
"2022/08/22","29530","24837","201592","19046","275005"
"2022/08/19","73869","3","104128","15727","193727"
"2022/08/18","114272","0","92524","19917","226713"
"2022/08/17","72219","618","142137","30900","245874"
"2022/08/16","57967","1","163106","117771","338845"
"2022/08/12","45067","3000","88778","98308","235153"
"2022/08/11","32394","13387","140269","111834","297884"
"2022/08/10","50862","0","136836","24763","212461"
"2022/08/09","95663","0","179114","38796","313573"
"2022/08/08","209464","5893","411918","73804","701079"
"2022/08/05","135743","38000","324669","70115","568527"
"2022/08/04","131535","48839","366727","162659","709760"
"2022/08/03","395833","45510","1196784","293735","1931862"
"2022/08/02","61413","10000","226178","66279","363870"
"2022/08/01","502134","4054","699255","167772","1373215"
"2022/07/29","110226","29300","368954","114358","622838"
"2022/07/28","39666","2000","132512","53910","228088"
"2022/07/27","15030","1327","123661","29296","169314"
"2022/07/26","39938","1676","96990","31549","170153"
"2022/07/25","59607","11000","140256","16786","227649"
"2022/07/22","148343","12630","208253","53549","422775"
"2022/07/21","202203","1001","219611","106173","528988"
"2022/07/20","215881","31000","245020","147112","639013"
"2022/07/19","636341","5000","286027","74015","1001383"
"2022/07/18","343493","9001","182947","205015","740456"
"2022/07/15","316976","100784","171948","160994","750702"
"2022/07/14","278650","150237","523616","75457","1027960"
"2022/07/13","626183","17119","254774","64035","962111"
"2022/07/12","746187","33893","440039","114815","1334934"
"2022/07/11","410215","13988","369539","158566","952308"
"2022/07/08","1186243","200","776954","132340","2095737"
"2022/07/07","575103","0","333646","108998","1017747"
"2022/07/06","484392","1","161370","220103","865866"
"2022/07/05","338326","1","268761","218338","825426"
"2022/07/04","1041188","11270","399091","238249","1689798"
"2022/07/01","556257","70001","658395","415033","1699686"
"2022/06/30","114383","0","518446","570265","1203094"
"2022/06/29","884905","149278","414452","591591","2040226"
"2022/06/28","292139","189155","803846","232461","1517601"
"2022/06/27","240071","7014","205509","111158","563752"
"2022/06/24","437341","70981","127025","186238","821585"
"2022/06/23","505701","15001","225641","244565","990908"
"2022/06/22","406127","0","367695","185636","959458"
"2022/06/21","187515","2","134247","191547","513311"
"2022/06/20","481562","35000","517740","191886","1226188"
"2022/06/17","263561","81084","444162","382776","1171583"
"2022/06/16","113428","90200","286453","173739","663820"
"2022/06/15","68724","5001","223554","158817","456096"
"2022/06/14","231183","0","288341","152443","671967"
"2022/06/13","149375","92682","289635","211373","743065"
"2022/06/10","265250","104880","263767","117751","751648"
"2022/06/09","125621","56000","80864","65207","327692"
"2022/06/08","299493","20001","71946","125057","516497"
"2022/06/07","504161","2","541861","116233","1162257"
"2022/06/03","195618","1","213266","189652","598537"
"2022/06/02","353939","0","67019","78728","499686"
"2022/05/31","182560","1","130505","466426","779492"
"2022/05/30","319363","13000","133023","81602","546988"
"2022/05/27","247076","60000","118508","115403","540987"
"2022/05/26","449547","1002","144391","142924","737864"
"2022/05/25","44631","1","176917","162243","383792"
"2022/05/24","98823","11000","170822","154543","435188"
"2022/05/23","141769","2500","553935","116762","814966"
"2022/05/20","85933","16001","161917","104009","367860"
"2022/05/19","113206","22001","359175","261924","756306"
"2022/05/18","68490","2000","86017","52685","209192"
"2022/05/17","140991","30503","468817","183988","824299"
"2022/05/16","83786","0","131344","95268","310398"
"2022/05/13","34087","2","172918","71294","278301"
"2022/05/12","193018","0","191006","170024","554048"
"2022/05/11","79357","11235","168265","126844","385701"
"2022/05/10","47522","10000","173303","148610","379435"
"2022/05/09","103383","1","186329","64737","354450"
"2022/05/06","300062","863","283184","57372","641481"
"2022/05/04","348943","3","188060","35894","572900"
"2022/05/03","479968","57000","395624","174569","1107161"
"2022/05/02","173116","0","128306","7925","309347"
"2022/04/29","407611","0","41818","149029","598458"
"2022/04/28","288977","1727","315336","155439","761479"
"2022/04/27","167408","2972","215815","166921","553116"
"2022/04/26","279239","25384","188180","245322","738125"
"2022/04/25","345369","41987","235998","196084","819438"
"2022/04/22","217207","0","109158","294458","620823"
"2022/04/21","135975","38504","131672","326467","632618"
"2022/04/20","268467","0","109689","316719","694875"
"2022/04/19","1569948","0","197883","107859","1875690"
"2022/04/18","605107","37800","947857","315816","1906580"
"2022/04/15","471037","42700","592227","84283","1190247"
"2022/04/14","544007","10916","731803","28151","1314877"
"2022/04/13","417687","11000","413628","84945","927260"
"2022/04/12","671833","35001","422697","11017","1140548"
"2022/04/11","545178","17737","276729","77213","916857"
"2022/04/08","511020","33133","390440","173724","1108317"
"2022/04/07","296844","60929","232452","127443","717668"
"2022/04/06","400559","40000","197337","32759","670655"
"2022/04/05","403731","62004","109179","34823","609737"
"2022/04/04","265299","40000","344153","9352","658804"
"2022/04/01","315984","0","257729","30069","603782"
"2022/03/31","472795","3","357881","40375","871054"
"2022/03/30","266859","72","267362","8867","543160"
"2022/03/29","222601","40","125958","16165","364764"
"2022/03/28","332376","3000","125436","80729","541541"
"2022/03/25","336853","4000","246060","33860","620773"
"2022/03/24","380066","32001","178527","9835","600429"
"2022/03/23","380571","9002","162616","47449","599638"
"2022/03/22","109764","89215","367860","65164","632003"
"2022/03/21","136420","119007","165751","41111","462289"
"2022/03/18","212732","111272","86443","92448","502895"
"2022/03/17","225990","119095","79826","103502","528413"
"2022/03/16","109479","83572","272989","39386","505426"
"2022/03/15","136861","180595","94472","13253","425181"
"2022/03/14","85295","197036","97123","17326","396780"
"2022/03/11","181176","202230","97176","21349","501931"
"2022/03/10","120904","245698","65984","33107","465693"
"2022/03/08","154992","162417","180176","40724","538309"
"2022/03/07","145207","118829","180212","51330","495578"
"2022/03/04","271745","188047","161989","27938","649719"
"2022/03/03","257381","106418","86948","98388","549135"
"2022/03/02","190402","106000","80315","58153","434870"
"2022/02/28","105020","0","237794","84813","427627"
"2022/02/25","261513","60008","200420","43697","565638"
"2022/02/24","274310","10000","275079","99977","659366"
"2022/02/23","102706","64915","151236","19875","338732"
"2022/02/22","215653","64","183601","64235","463553"
"2022/02/21","122084","0","216654","34589","373327"
"2022/02/18","341144","2001","76870","6468","426483"
"2022/02/17","263356","403","381512","60410","705681"
"2022/02/16","143229","1","269810","22281","435321"
"2022/02/15","31737","1800","246365","21746","301648"
"2022/02/14","45076","54005","160060","3491","262632"
"2022/02/11","171694","78047","93670","18933","362344"
"2022/02/10","145337","58","152701","8882","306978"
"2022/02/09","216814","3009","99714","16350","335887"
"2022/02/08","246198","0","105452","75271","426921"
"2022/02/07","245700","1","94383","28600","368684"
"2022/02/04","125979","667","99542","127543","353731"
"2022/02/03","127568","67290","189495","71897","456250"
"2022/01/28","326014","212686","186574","96380","821654"
"2022/01/27","374984","3","412604","188722","976313"
"2022/01/26","199069","19","124464","67698","391250"
"2022/01/25","223319","10013","385201","119555","738088"
"2022/01/24","245633","6","162357","93101","501097"
"2022/01/21","102190","11406","295629","15880","425105"
"2022/01/20","181503","503","142940","41706","366652"
"2022/01/19","107682","1","455638","44399","607720"
"2022/01/18","386476","14497","85206","36865","523044"
"2022/01/17","305383","24005","347785","77348","754521"
"2022/01/14","255632","21500","179199","22693","479024"
"2022/01/13","232272","0","111540","26354","370166"
"2022/01/12","70521","9601","92878","61430","234430"
"2022/01/11","380512","0","253746","82695","716953"
"2022/01/10","189518","6002","162630","13741","371891"
"2022/01/07","81059","10486","147177","15378","254100"
"2022/01/06","200430","6000","279364","6949","492743"
"2022/01/05","227617","2189","240996","106959","577761"
"2022/01/04","398364","30447","289955","24093","742859"
"2022/01/03","377978","17779","139002","57390","592149"
"2021/12/30","389835","134696","162269","96593","783393"
"2021/12/29","336397","134516","344642","503194","1318749"
"2021/12/28","375707","58050","765158","76901","1275816"
"2021/12/27","2106045","6041","542616","124180","2778882"
"2021/12/24","429991","9001","194700","30360","664052"
"2021/12/23","483988","72999","103683","9613","670283"
"2021/12/22","315351","19401","119881","2824","457457"
"2021/12/21","398192","7","135414","7737","541350"
"2021/12/20","275498","0","263501","70326","609325"
"2021/12/17","297509","73934","142893","39388","553724"
"2021/12/16","144571","10002","88914","53907","297394"
"2021/12/15","412812","61855","100339","62773","637779"
"2021/12/14","261052","49000","88525","35626","434203"
"2021/12/13","227190","7001","90418","10545","335154"
"2021/12/10","337714","3001","70452","44258","455425"
"2021/12/09","531482","6001","177476","17374","732333"
"2021/12/08","561707","17600","104058","55629","738994"
"2021/12/07","454601","0","36805","72325","563731"
"2021/12/06","237938","0","56057","32397","326392"
"2021/12/03","398741","4002","52653","53832","509228"
"2021/12/02","474491","0","141606","61515","677612"
"2021/12/01","261700","52561","215502","56589","586352"
"2021/11/30","555210","1013","336251","243646","1136120"
"2021/11/29","279846","55000","149999","93275","578120"
"2021/11/26","395568","2000","274870","22469","694907"
"2021/11/25","365819","26802","108503","33669","534793"
"2021/11/24","372323","14640","78423","14342","479728"
"2021/11/23","195994","2440","140217","28905","367556"
"2021/11/22","207278","51448","76253","172559","507538"
"2021/11/19","311999","17718","109973","96699","536389"
"2021/11/18","318951","8454","281398","109618","718421"
"2021/11/17","445162","2449","246221","30365","724197"
"2021/11/16","327374","23083","150576","40800","541833"
"2021/11/15","177882","70002","74033","73518","395435"
"2021/11/12","229304","10000","48159","80287","367750"
"2021/11/11","445055","22500","75378","38016","580949"
"2021/11/10","276178","130000","132577","151474","690229"
"2021/11/09","410301","20000","161267","68293","659861"
"2021/11/08","641864","69987","110162","40832","862845"
"2021/11/05","419742","19779","197423","68191","705135"
"2021/11/04","341130","30204","91556","75308","538198"
"2021/11/03","280194","60000","137797","60069","538060"
"2021/11/02","249483","25000","106547","41960","422990"
"2021/11/01","220952","8000","383791","63381","676124"
"2021/10/29","238632","0","200378","144636","583646"
"2021/10/28","574293","70000","339615","117412","1101320"
"2021/10/27","432027","68700","88944","15602","605273"
"2021/10/26","499724","0","70431","68831","638986"
"2021/10/25","557754","0","84997","61443","704194"
"2021/10/22","589834","0","20121","60149","670104"
"2021/10/21","481440","0","126477","28902","636819"
"2021/10/20","430719","0","101340","33118","565177"
"2021/10/19","498830","0","298954","22591","820375"
"2021/10/18","213428","20000","57466","38460","329354"
"2021/10/15","415795","10000","47623","120213","593631"
"2021/10/14","232197","0","56451","58291","346939"
"2021/10/13","276746","20000","99050","131346","527142"
"2021/10/12","335899","89200","364862","56584","846545"
"2021/10/08","323995","3700","83801","18687","430183"
"2021/10/07","357635","20000","68319","12691","458645"
"2021/10/06","731695","25032","514263","30680","1301670"
"2021/10/05","362350","5000","359579","28291","755220"
"2021/10/01","410910","15944","236308","56116","719278"
"2021/09/30","691804","0","53471","34066","779341"
"2021/09/29","478614","11643","272089","49813","812159"
"2021/09/28","659351","0","248549","121648","1029548"
"2021/09/27","1565105","45167","309462","58907","1978641"
"2021/09/24","1513985","500","345040","71533","1931058"
"2021/09/23","724209","3013","402453","235514","1365189"
"2021/09/17","4650015","1300","192689","160261","5004265"
"2021/09/16","1567657","1700","441013","24873","2035243"
"2021/09/15","346808","19740","153498","317114","837160"
"2021/09/14","530408","8500","95892","144852","779652"
"2021/09/13","520575","2109","234416","107022","864122"
"2021/09/10","394519","2437","61457","29363","487776"
"2021/09/09","421110","35664","105291","63367","625432"
"2021/09/08","286697","20000","49351","89242","445290"
"2021/09/07","245662","0","110010","96320","451992"
"2021/09/06","287692","20200","80807","99431","488130"
"2021/09/03","194849","2000","86418","393125","676392"
"2021/09/02","193767","475","310729","543707","1048678"
"2021/09/01","315977","113770","322104","20285","772136"
"2021/08/31","455622","0","238237","506605","1200464"
"2021/08/30","186446","0","162369","36647","385462"
"2021/08/27","190297","30000","286055","27547","533899"
"2021/08/26","91324","75935","139477","39057","345793"
"2021/08/25","255276","5000","190524","27377","478177"
"2021/08/24","285627","20000","125710","12846","444183"
"2021/08/23","503959","14","196756","116511","817240"
"2021/08/20","153969","100","293586","147823","595478"
"2021/08/19","121183","2544","333009","43538","500274"
"2021/08/18","117212","0","251736","5129","374077"
"2021/08/17","293007","11906","133634","41644","480191"
"2021/08/13","307370","0","268005","49691","625066"
"2021/08/12","174801","0","206609","6023","387433"
"2021/08/11","221638","1906","163281","16771","403596"
"2021/08/10","161125","3657","99552","14276","278610"
"2021/08/09","1070211","1343","151333","402660","1625547"
"2021/08/06","431518","0","148913","2521","582952"
"2021/08/05","460003","16632","124809","238998","840442"
"2021/08/04","355516","55","99640","76662","531873"
"2021/08/03","286985","0","175405","341819","804209"
"2021/08/02","164519","0","122731","92073","379323"
"2021/07/30","260427","1892","129338","35572","427229"
"2021/07/29","168220","2","109581","33639","311442"
"2021/07/28","364972","0","200910","329305","895187"
"2021/07/27","168999","2000","99216","11528","281743"
"2021/07/26","374922","10238","319342","62804","767306"
"2021/07/23","272514","121","118790","86031","477456"
"2021/07/22","267940","4864","175623","58079","506506"
"2021/07/21","1218603","1000","113521","8712","1341836"
"2021/07/20","309148","795","89888","22060","421891"
"2021/07/19","158423","30000","127376","16089","331888"
"2021/07/16","227576","7111","131577","2489","368753"
"2021/07/15","292635","10345","98603","29450","431033"
"2021/07/14","487310","10000","51158","16728","565196"
"2021/07/13","249019","0","63654","4401","317074"
"2021/07/12","202369","21615","111675","83054","418713"
"2021/07/09","65670","0","220258","90755","376683"
"2021/07/08","150680","0","224911","51860","427451"
"2021/07/07","161997","0","117522","50501","330020"
"2021/07/06","259921","0","204267","128676","592864"
"2021/07/05","859232","0","464794","203039","1527065"
"2021/07/02","448241","6913","470227","4892","930273"
"2021/07/01","412012","0","342437","19849","774298"
"2021/06/30","406839","5585","210986","43416","666826"
"2021/06/29","1143225","35781","185145","480050","1844201"
"2021/06/28","1072473","135686","834464","144953","2187576"
"2021/06/25","531314","1932","172804","182309","888359"
"2021/06/24","321481","3863","173578","34119","533041"
"2021/06/23","618076","0","218416","133606","970098"
"2021/06/22","537613","101384","34235","22856","696088"
"2021/06/21","284820","0","450292","67273","802385"
"2021/06/18","2457241","9868","276799","163823","2907731"
"2021/06/17","867461","0","26678","54025","948164"
"2021/06/16","2085744","150000","122833","82193","2440770"
"2021/06/15","885459","0","55966","60082","1001507"
"2021/06/14","2082821","0","69830","50344","2202995"
"2021/06/11","496240","10000","112237","96970","715447"
"2021/06/10","4059278","0","79737","23471","4162486"
"2021/06/09","1130627","0","54067","52356","1237050"
"2021/06/08","391130","0","53019","53575","497724"
"2021/06/07","476607","11000","75095","69498","632200"
"2021/06/04","295038","0","53894","103527","452459"
"2021/06/03","1189877","1000","195664","308477","1695018"
"2021/06/02","6391079","13037","225224","141511","6770851"
"2021/06/01","1910030","0","116241","116631","2142902"
"2021/05/31","505847","19474","135657","85086","746064"
"2021/05/28","256267","0","77293","110315","443875"
"2021/05/27","606119","38728","39967","65859","750673"
"2021/05/26","130745","0","38840","49964","219549"
"2021/05/25","287301","0","68884","133715","489900"
"2021/05/24","285483","0","213588","51002","550073"
"2021/05/21","134959","10000","109734","37752","292445"
"2021/05/20","177757","59691","104778","40367","382593"
"2021/05/18","301616","0","46893","50379","398888"
"2021/05/17","67854","56000","69762","50041","243657"
"2021/05/14","266411","0","58141","85659","410211"
"2021/05/13","307640","30000","118068","167063","622771"
"2021/05/12","158056","0","112604","107106","377766"
"2021/05/11","188249","0","39627","102950","330826"
"2021/05/10","366437","0","129508","146125","642070"
"2021/05/07","196482","20675","82199","565583","864939"
"2021/05/06","206788","0","82631","326511","615930"
"2021/05/04","278955","0","172050","222290","673295"
"2021/05/03","315352","3500","64335","256249","639436"
"2021/04/30","368905","0","46655","278225","693785"
"2021/04/29","10363175","20000","94918","135421","10613514"
"2021/04/28","727943","60000","56952","235544","1080439"
"2021/04/27","323001","10000","89809","111956","534766"
"2021/04/26","283130","0","240251","129148","652529"
"2021/04/23","232803","0","54930","82985","370718"
"2021/04/22","243711","1","61371","160092","465175"
"2021/04/21","53122","3000","42787","110381","209290"
"2021/04/20","134323","0","59592","248608","442523"
"2021/04/19","346943","0","85535","133504","565982"
"2021/04/16","502733","0","38272","147556","688561"
"2021/04/15","5437721","3523","49628","111694","5602566"
"2021/04/14","152841","0","26913","138934","318688"
"2021/04/13","7333797","0","32712","27862","7394371"
"2021/04/12","205660","0","64695","80010","350365"
"2021/04/09","5239621","0","55718","38210","5333549"
"2021/04/08","317311","0","12987","11404","341702"
"2021/04/07","130337","0","33368","2467","166172"
"2021/04/06","121351","0","41868","14547","177766"
"2021/04/05","192131","0","165759","3207","361097"
"2021/04/02","162713","0","109385","8658","280756"
"2021/04/01","164962","3522","48257","691","217432"
"2021/03/31","238126","0","48710","57989","344825"
"2021/03/30","1133390","150","40602","3826","1177968"
"2021/03/29","5083033","0","67189","46068","5196290"
"2021/03/26","4382060","0","194582","29956","4606598"
"2021/03/25","96067","0","56020","19473","171560"
"2021/03/24","91779","0","64604","18874","175257"
"2021/03/23","138392","0","172610","5401","316403"
"2021/03/22","66192","0","53488","16560","136240"
"2021/03/19","126525","1000","67817","105440","300782"
"2021/03/18","62634","4000","66032","3971","136637"
"2021/03/17","12830","0","61042","8084","81956"
"2021/03/16","21937","2000","56529","20356","100822"
"2021/03/15","94998","20000","79213","10817","205028"
"2021/03/12","112165","6000","59255","4849","182269"
"2021/03/11","30233","0","86393","31317","147943"
"2021/03/10","27637","0","88968","64750","181355"
"2021/03/09","36847","0","73186","14085","124118"
"2021/03/08","31795","6000","71535","3442","112772"
"2021/03/05","12966","0","97628","6003","116597"
"2021/03/04","2328","0","40384","15847","58559"
"2021/03/03","13739","0","58226","68278","140243"
"2021/03/02","60716","32","79922","13270","153940"
"2021/02/26","55525","0","107505","37155","200185"
"2021/02/25","41158","0","122209","46212","209579"
"2021/02/24","22514","0","160102","72833","255449"
"2021/02/23","92286","0","69754","19178","181218"
"2021/02/22","6409","0","160340","117736","284485"
"2021/02/19","143846","0","97454","16830","258130"
"2021/02/18","57918","0","53916","8534","120368"
"2021/02/17","141948","0","25025","7428","174401"
"2021/02/16","69888","25000","25875","4970","125733"
"2021/02/15","24393","0","103740","534","128667"
"2021/02/10","26417","0","76309","4017","106743"
"2021/02/09","21024","20000","81786","7712","130522"
"2021/02/08","101568","0","217631","11665","330864"
"2021/02/05","72852","0","89791","902","163545"
"2021/02/04","67934","4549","101608","2456","176547"
"2021/02/03","52269","0","35891","65142","153302"
"2021/02/02","65311","0","32410","2559","100280"
"2021/02/01","14677",,"60869","3908","79454"
"2021/01/29","55903","0","85990","0","141893"
"2021/01/28","65178","1000","53045","1238","120461"
"2021/01/27","43061","0","66754","311","110126"
"2021/01/26","56576","4000","131340","8477","200393"
"2021/01/25","34888","0","49181","1768","85837"
"2021/01/22","113899","0","57375","3226","174500"
"2021/01/21","82061","34","38087","256","120438"
"2021/01/20","84056","1636","98325","28832","212849"
"2021/01/19","64418","0","154500","19712","238630"
"2021/01/18","83717","2243","252943","31242","370145"
"2021/01/15","95417","2601","143795","10270","252083"
"2021/01/14","65890","733","46394","6200","119217"
"2021/01/13","34215","1737","100664","53505","190121"
"2021/01/12","90556","0","143611","8754","242921"
"2021/01/11","310710","14000","246505","34815","606030"
"2021/01/08","233438","4821","264053","3697","506009"
"2021/01/07","209109","0","235922","5207","450238"
"2021/01/06","152197","20000","56041","9504","237742"
"2021/01/05","216818","88","134767","10042","361715"
"2021/01/04","184016","15000","185503","46389","430908"
"2020/12/30","95199","0","171304","63605","330108"
"2020/12/29","243912","1000","319303","45399","609614"
"2020/12/28","663059","7500","267991","4503","943053"
"2020/12/24","131428","20000","109319","2485","263232"
"2020/12/23","1079729","46933","88117","10364","1225143"
"2020/12/22","49403","56778","167922","17964","292067"
"2020/12/21","80578","42224","141207","38568","302577"
"2020/12/18","575893","6000","591376","2115212","3288481"
"2020/12/17","385830","21274","336277","19856","763237"
"2020/12/16","286536","26000","249360","146641","708537"
"2020/12/15","446528","34","247811","13586","707959"
"2020/12/14","142725","0","189753","2027","334505"
"2020/12/11","215050","10206","134165","100688","460109"
"2020/12/10","100363","20194","168132","6136","294825"
"2020/12/09","134448","233","98669","10316","243666"
"2020/12/08","123231","0","70866","9080","203177"
"2020/12/07","281773","1000","72007","6835","361615"
"2020/12/04","406327","0","62119","4098","472544"
"2020/12/03","59948",,"83628","8227","151803"
"2020/12/02","36068","603","90859","11787","139317"
"2020/12/01","222167","1000","66273","137621","427061"
"2020/11/30","172334","15753","72297","291588","551972"
"2020/11/27","104369","600","135636","10098","250703"
"2020/11/26","122175","20000","68727","7493","218395"
"2020/11/25","248994","0","133477","31669","414140"
"2020/11/24","213448","0","29581","52877","295906"
"2020/11/23","233030","20000","179646","7112","439788"
"2020/11/20","41980","2000","48826","11923","104729"
"2020/11/19","89802","0","148018","10665","248485"
"2020/11/18","106246","0","81839","23344","211429"
"2020/11/17","297761","8100","60566","26783","393210"
"2020/11/16","264444","0","130912","24535","419891"
"2020/11/13","318005","0","87394","31205","436604"
"2020/11/12","172564","0","47563","24642","244769"
"2020/11/11","120328",,"67030","39332","226690"
"2020/11/10","148505","20000","68786","6175","243466"
"2020/11/09","279307","15000","71962","34469","400738"
"2020/11/06","135072",,"62026","18588","215686"
"2020/11/05","120766","0","57667","17594","196027"
"2020/11/04","44336","600","64190","14379","123505"
"2020/11/03","82908","1000","66500","24833","175241"
"2020/11/02","82990","0","129910","29406","242306"
"2020/10/30","102781","0","182053","10514","295348"
"2020/10/29","30243","0","54045","23300","107588"
"2020/10/28","32779","0","86144","1","118924"
"2020/10/27","156068","20000","114453","33161","323682"
"2020/10/26","93720","0","151748","24818","270286"
"2020/10/23","54591","14887","116897","7721","194096"
"2020/10/22","123129","38","223900","14508","361575"
"2020/10/21","66663","5113","70970","13533","156279"
"2020/10/20","52085","0","62893","4454","119432"
"2020/10/19","96553","0","40952","24102","161607"
"2020/10/16","210121","75000","74449","14892","374462"
"2020/10/15","40271",,"106125","21716","168112"
"2020/10/14","32508","50022","105326","14035","201891"
"2020/10/13","143147","20","200074","11546","354787"
"2020/10/12","86456","0","161543","2771","250770"
"2020/10/08","237942","0","95777","4097","337816"
"2020/10/07","115408","0","11118","12474","139000"
"2020/10/06","258932","200","53132","4125","316389"
"2020/10/05","107937","0","71995","8740","188672"
"2020/09/29","36514","15000","62450","159","114123"
"2020/09/28","13001","20000","21233","4401","58635"
"2020/09/25","37352","20000","42284","61279","160915"
"2020/09/24","15353","1254","71534","8072","96213"
"2020/09/23","158246","70746","192492","25723","447207"
"2020/09/22","26646","7309","126649","7093","167697"
"2020/09/21","166766","0","25209","99","192074"
"2020/09/18","72089","0","47950","1321","121360"
"2020/09/17","203180","6000","41958","14273","265411"
"2020/09/16","68554","0","104698","4187","177439"
"2020/09/15","51775","16605","40380","11","108771"
"2020/09/14","267248","0","75041","4217","346506"
"2020/09/11","122901","14760","72133","1353","211147"
"2020/09/10","53384","34742","81869","4389","174384"
"2020/09/09","49350","8459","102804","7727","168340"
"2020/09/08","208839","55911","223036","5184","492970"
"2020/09/07","28746","78673","181435","16456","305310"
"2020/09/04","103783","1829","66783","1143","173538"
"2020/09/03","145709","38082","46843","9600","240234"
"2020/09/02","127454","20776","46992","0","195222"
"2020/09/01","27138","6152","58272","395","91957"
"2020/08/31","58819","0","128228","8346","195393"
"2020/08/28","36096","2564","260982","6302","305944"
"2020/08/27","107899","30000","63286","3003","204188"
"2020/08/26","157934","20000","109887","3345","291166"
"2020/08/25","159755","0","149173","0","308928"
"2020/08/24","369819","1632","77470","1625","450546"
"2020/08/21","288327","0","47552","7703","343582"
"2020/08/20","366608","0","281159","21709","669476"
"2020/08/19","407286","0","87820","18993","514099"
"2020/08/18","375343","7100","200230","3811","586484"
"2020/08/14","154474","25052","292125","12183","483834"
"2020/08/13","843477","0","172218","14322","1030017"
"2020/08/12","309446","85828","570186","22750","988210"
"2020/08/11","237168","0","557891","14368","809427"
"2020/08/10","554201","0","489261","13104","1056566"
"2020/08/07","2816688","62434","1350819","552456","4782397"