일자,기관 합계,기타법인,개인,외국인 합계,전체
"2023/05/04","1443","232","33416","2813","37904"
"2023/05/03","8436","15","69690","566","78707"
"2023/05/02","187","0","43812","2035","46034"
"2023/04/28","140","17","66900","4649","71706"
"2023/04/27","14905","3","133277","9713","157898"
"2023/04/26","16528","0","125395","578","142501"
"2023/04/25","1061","4201","392761","2048","400071"
"2023/04/24","978","2","99270","5009","105259"
"2023/04/21","655","0","128787","2965","132407"
"2023/04/20","576","3","99455","6495","106529"
"2023/04/19","7661","0","576222","7885","591768"
"2023/04/18","17520","3","883179","3173","903875"
"2023/04/17","18954","8","272506","2683","294151"
"2023/04/14","7017","1","190261","421","197700"
"2023/04/13","7567","2","77091","1115","85775"
"2023/04/12","6507","2","73623","360","80492"
"2023/04/11","4610","1","106557","13","111181"
"2023/04/10","6664","1","110310","408","117383"
"2023/04/07","1273","1","72581","2","73857"
"2023/04/06","932","0","124998","1220","127150"
"2023/04/05","399","0","81508","2801","84708"
"2023/04/04","233","0","56064","789","57086"
"2023/04/03","4480","0","38066","4939","47485"
"2023/03/31","191","9030","265581","6638","281440"
"2023/03/30","4529","1830","56754","6858","69971"
"2023/03/29","30355","0","53653","6094","90102"
"2023/03/28","7010","0","19544","6453","33007"
"2023/03/27","259","1","48099","2834","51193"
"2023/03/24","222","1790","132658","5578","140248"
"2023/03/23","18120","1461","83856","6074","109511"
"2023/03/22","30","1890","33743","5148","40811"
"2023/03/21","104","0","21680","6082","27866"
"2023/03/20","66","0","36059","5290","41415"
"2023/03/17","1685","14","39722","6043","47464"
"2023/03/16","22177","8","59565","5845","87595"
"2023/03/15","1061","0","73878","5948","80887"
"2023/03/14","38103","2","86736","6499","131340"
"2023/03/13","4344","9","104893","7991","117237"
"2023/03/10","574","0","44209","5883","50666"
"2023/03/09","3406","2","126415","5628","135451"
"2023/03/08","1115","1","69523","5809","76448"
"2023/03/07","788","988","102242","6279","110297"
"2023/03/06","3279","1","66585","6013","75878"
"2023/03/03","2032","5628","23915","9242","40817"
"2023/03/02","457","689","37716","5326","44188"
"2023/02/28","9","462","15076","6027","21574"
"2023/02/27","4","0","58079","6395","64478"
"2023/02/24","1774","0","47014","4977","53765"
"2023/02/23","45","2","75042","5728","80817"
"2023/02/22","61","1150","107927","6604","115742"
"2023/02/21","16","862","22798","6509","30185"
"2023/02/20","11377","2","41402","4227","57008"
"2023/02/17","1064","0","24094","1844","27002"
"2023/02/16","4004","1","24743","2342","31090"
"2023/02/15","12378","10","38077","5762","56227"
"2023/02/14","1054","0","25456","1070","27580"
"2023/02/13","1146","1","69483","967","71597"
"2023/02/10","3023","0","33575","604","37202"
"2023/02/09","1000","0","51619","14","52633"
"2023/02/08","268","1","55447","4508","60224"
"2023/02/07","464","1","16927","508","17900"
"2023/02/06","17808","0","17786","260","35854"
"2023/02/03","5623","79","115336","384","121422"
"2023/02/02","59073","9","92739","158","151979"
"2023/02/01","763","0","84335","59","85157"
"2023/01/31","65","0","18749","156","18970"
"2023/01/30","156","0","30707","8","30871"
"2023/01/27","255","0","40245","3779","44279"
"2023/01/26","444","1","39542","1318","41305"
"2023/01/25","648","0","22642","1","23291"
"2023/01/20","922","1","67421","243","68587"
"2023/01/19","8","0","17558","314","17880"
"2023/01/18","769","2","26414","11","27196"
"2023/01/17","2040","0","67686","870","70596"
"2023/01/16","42821","0","64617","0","107438"
"2023/01/13","883","0","38403","3745","43031"
"2023/01/12","760","0","26597","4455","31812"
"2023/01/11","487","1","72273","1585","74346"
"2023/01/10","2040","0","29805","308","32153"
"2023/01/09","1607","1","38261","192","40061"
"2023/01/06","3316","0","75298","6","78620"
"2023/01/05","247","0","49098","2797","52142"
"2023/01/04","69","1","32043","2428","34541"
"2023/01/03","403","0","32141","5900","38444"
"2023/01/02","3121","0","13036","3852","20009"
"2022/12/29","9527","0","110632","8196","128355"
"2022/12/28","18688","40149","95601","11954","166392"
"2022/12/27","21390","19850","103391","745","145376"
"2022/12/26","116","45201","36414","2008","83739"
"2022/12/23","100","1","22487","1596","24184"
"2022/12/22","200","4","24692","626","25522"
"2022/12/21","306","1","12597","437","13341"
"2022/12/20","9265","2","20960","2938","33165"
"2022/12/19","2966","0","51804","866","55636"
"2022/12/16","152","0","83453","895","84500"
"2022/12/15","9318","955","35952","906","47131"
"2022/12/14","30","0","21368","688","22086"
"2022/12/13","236","0","41690","550","42476"
"2022/12/12","10278","0","39443","3124","52845"
"2022/12/09","5387","0","24597","1624","31608"
"2022/12/08","2131","0","21824","1662","25617"
"2022/12/07","609","0","32354","837","33800"
"2022/12/06","370","0","46439","2516","49325"
"2022/12/05","16632","4","68036","530","85202"
"2022/12/02","2641","2","167797","2891","173331"
"2022/12/01","913","5","124707","869","126494"
"2022/11/30","1409","3","83380","224","85016"
"2022/11/29","419","7","17103","577","18106"
"2022/11/28","113","0","47481","2740","50334"
"2022/11/25","2765","0","43983","20","46768"
"2022/11/24","1086","0","93369","252","94707"
"2022/11/23","5","0","127567","475","128047"
"2022/11/22","12369","0","30377","832","43578"
"2022/11/21","1","0","33215","1032","34248"
"2022/11/18","52","0","28519","751","29322"
"2022/11/17","270","0","12119","286","12675"
"2022/11/16","9515","0","34988","3906","48409"
"2022/11/15","1705","0","30518","3238","35461"
"2022/11/14","6574","0","47534","4501","58609"
"2022/11/11","56087","0","90185","9232","155504"
"2022/11/10","1825","0","59585","5527","66937"
"2022/11/09","1125","0","89345","8885","99355"
"2022/11/08","15852","0","77109","8817","101778"
"2022/11/07","391","3","18535","2831","21760"
"2022/11/04","521","17","25557","4801","30896"
"2022/11/03","11988","0","40457","8745","61190"
"2022/11/02","1991","0","18644","4484","25119"
"2022/11/01","13457","0","53060","747","67264"
"2022/10/31","11736","0","22288","417","34441"
"2022/10/28","8","0","29722","1180","30910"
"2022/10/27","209","0","99310","486","100005"
"2022/10/26","5704","0","33593","1174","40471"
"2022/10/25","1406","6","43736","99","45247"
"2022/10/24","449","14","34711","724","35898"
"2022/10/21","492","0","35508","4352","40352"
"2022/10/20","18118","0","36551","3695","58364"
"2022/10/19","3280","0","75627","767","79674"
"2022/10/18","4712","0","60614","79","65405"
"2022/10/17","2938","1","76133","703","79775"
"2022/10/14","2902","0","33785","758","37445"
"2022/10/13","4715","0","228680","7590","240985"
"2022/10/12","65","0","40248","1037","41350"
"2022/10/11","161","0","76029","7391","83581"
"2022/10/07","8873","0","38131","92","47096"
"2022/10/06","1797","0","36672","675","39144"
"2022/10/05","139","0","64688","4050","68877"
"2022/10/04","4349","0","44371","424","49144"
"2022/09/30","1300","1","58685","2802","62788"
"2022/09/29","39960","0","44273","1065","85298"
"2022/09/28","266","0","140939","13312","154517"
"2022/09/27","1306","0","137032","14338","152676"
"2022/09/26","28063","0","254076","26378","308517"
"2022/09/23","66892","0","79200","10725","156817"
"2022/09/22","563","0","40966","6777","48306"
"2022/09/21","50","0","48070","923","49043"
"2022/09/20","49",,"35716","3","35768"
"2022/09/19","2695",,"64547","26866","94108"
"2022/09/16","1416","0","30091","2665","34172"
"2022/09/15","9824","1","40758","2034","52617"
"2022/09/14","12172",,"87501","3079","102752"
"2022/09/13","913",,"58342","623","59878"
"2022/09/08","337","0","34738","1153","36228"
"2022/09/07","1930","1","54290","11192","67413"
"2022/09/06","348","0","36085","907","37340"
"2022/09/05","30","0","91244","1726","93000"
"2022/09/02","263","0","73930","2","74195"
"2022/09/01","52456","34356","111633","17174","215619"
"2022/08/31","1275","2719","35471","7219","46684"
"2022/08/30","10801","1540","116812","24135","153288"
"2022/08/29","699","11380","173148","9178","194405"
"2022/08/26","3950","1530","31843","11443","48766"
"2022/08/25","27545","0","19658","5573","52776"
"2022/08/24","570","0","122444","24226","147240"
"2022/08/23","1136","0","85197","5658","91991"
"2022/08/22","1926","0","41195","16307","59428"
"2022/08/19","34","355","138710","8064","147163"
"2022/08/18","9273","2130","69041","15448","95892"
"2022/08/17","858","0","38452","11273","50583"
"2022/08/16","9974","0","97636","10427","118037"
"2022/08/12","13583","1870","95400","5398","116251"
"2022/08/11","3466","3900","95613","10260","113239"
"2022/08/10","14655","0","45687","4904","65246"
"2022/08/09","950","1560","23632","28249","54391"
"2022/08/08","52","3010","42961","6013","52036"
"2022/08/05","6161","3802","60574","2394","72931"
"2022/08/04","112","13266","95737","18698","127813"
"2022/08/03","4666","11386","35699","10669","62420"
"2022/08/02","9030","15328","60479","28980","113817"
"2022/08/01","371","15906","56868","16205","89350"
"2022/07/29","2371","23943","106087","15658","148059"
"2022/07/28","4690","22","42109","25212","72033"
"2022/07/27","2323","2018","65477","12149","81967"
"2022/07/26","4283","1","54325","23168","81777"
"2022/07/25","14896","12","86142","10317","111367"
"2022/07/22","3752","1710","97469","21246","124177"
"2022/07/21","171","0","109387","5292","114850"
"2022/07/20","2950","3","193265","9503","205721"
"2022/07/19","13808","4","149284","3601","166697"
"2022/07/18","717","20000","90699","1319","112735"
"2022/07/15","8962","0","134904","1582","145448"
"2022/07/14","10073","0","176460","6300","192833"
"2022/07/13","42","0","56083","8166","64291"
"2022/07/12","1198","1","207725","80417","289341"
"2022/07/11","35","1","161175","6337","167548"
"2022/07/08","4204","224","172231","18981","195640"
"2022/07/07","956","0","92900","12407","106263"
"2022/07/06","1","3","80243","10918","91165"
"2022/07/05","2055","0","42666","2176","46897"
"2022/07/04","4","0","136153","56014","192171"
"2022/07/01","1750","0","38936","53848","94534"
"2022/06/30","855","10030","37842","48681","97408"
"2022/06/29","3622","0","108899","37858","150379"
"2022/06/28","2289","1","196035","20943","219268"
"2022/06/27","4096","0","94815","21926","120837"
"2022/06/24","4693","1709","84866","18701","109969"
"2022/06/23","29144","0","295229","129087","453460"
"2022/06/22","550","0","532639","61860","595049"
"2022/06/21","723","500","142320","21635","165178"
"2022/06/20","750","1709","501329","91082","594870"
"2022/06/17","4052","0","480672","44471","529195"
"2022/06/16","34555","0","142267","28587","205409"
"2022/06/15","213","12","132478","41893","174596"
"2022/06/14","10331","1709","298888","22890","333818"
"2022/06/13","281","0","246084","69725","316090"
"2022/06/10","13092","0","79020","24122","116234"
"2022/06/09","880","1","52069","31250","84200"
"2022/06/08","976","1700","128751","6763","138190"
"2022/06/07","693","628","103882","16002","121205"
"2022/06/03","10408","0","153153","42000","205561"
"2022/06/02","966","0","108235","22429","131630"
"2022/05/31","5501","0","298540","28155","332196"
"2022/05/30","4470","0","84631","2471","91572"
"2022/05/27","1","1","360817","5770","366589"
"2022/05/26","16246","25","246742","715","263728"
"2022/05/25","2","0","262646","1744","264392"
"2022/05/24","7629","0","84679","15998","108306"
"2022/05/23","14765","0","130213","13135","158113"
"2022/05/20","4","0","59672","2908","62584"
"2022/05/19","3208","0","149081","17440","169729"
"2022/05/18","5957","14000","112828","14942","147727"
"2022/05/17","2501","40000","79464","16264","138229"
"2022/05/16","14988","20007","165754","11145","211894"
"2022/05/13","15665","13000","447672","30037","506374"
"2022/05/12","32368","800","413136","220436","666740"
"2022/05/11","400","8","100867","57705","158980"
"2022/05/10","52270","312","209974","22694","285250"
"2022/05/09","800","0","273075","48725","322600"
"2022/05/06","8599","0","180254","20407","209260"
"2022/05/04","29857","2","218825","77344","326028"
"2022/05/03","11864","2","158725","37220","207811"
"2022/05/02","8076","1","230328","27966","266371"
"2022/04/29","10239","4000","118000","36132","168371"
"2022/04/28","3736","2500","172379","71341","249956"
"2022/04/27","6019","810","145988","34793","187610"
"2022/04/26","2085","14000","363706","25746","405537"
"2022/04/25","11429","10000","329557","33702","384688"
"2022/04/22","2300","1","94434","34774","131509"
"2022/04/21","2000","6300","214115","17289","239704"
"2022/04/20","4576","188","282955","26848","314567"
"2022/04/19","124","80","177173","64513","241890"
"2022/04/18","1812","1501","539512","71454","614279"
"2022/04/15","19122","5860","441739","201064","667785"
"2022/04/14","266","4","117343","119738","237351"
"2022/04/13","21914","0","525085","87206","634205"
"2022/04/12","2235","0","233346","70221","305802"
"2022/04/11","6220","1","394609","40685","441515"
"2022/04/08","12187","0","285180","91719","389086"
"2022/04/07","3624","2","387317","57831","448774"
"2022/04/06","2395","7","276823","19786","299011"
"2022/04/05","10189","5","298655","48635","357484"
"2022/04/04","2913","9","359926","74176","437024"
"2022/04/01","6010","5096","454403","30981","496490"
"2022/03/31","20562","6900","402264","118838","548564"
"2022/03/30","19739","36998","676285","153958","886980"
"2022/03/29","5243","12005","255882","154466","427596"
"2022/03/28","37752","27000","836598","68999","970349"
"2022/03/25","52151","22765","868652","235319","1178887"
"2022/03/24","9315","40004","503359","30160","582838"
"2022/03/23","18959","40000","500312","45506","604777"
"2022/03/22","2470","0","201282","28113","231865"
"2022/03/21","1544","5303","96797","28865","132509"
"2022/03/18","3066","0","37285","22511","62862"
"2022/03/17","635","1000","349623","82522","433780"
"2022/03/16","13869","5000","128744","52200","199813"
"2022/03/15","5013","5001","91004","29812","130830"
"2022/03/14","201","5002","243437","47597","296237"
"2022/03/11","9446","50001","671367","31282","762096"
"2022/03/10","3586","0","265259","38002","306847"
"2022/03/08","16974","0","226878","62793","306645"
"2022/03/07","205","2140","470477","127326","600148"
"2022/03/04","13067","1566","1118586","95407","1228626"
"2022/03/03","81722","500","1522540","425571","2030333"
"2022/03/02","49196","36000","879611","197065","1161872"
"2022/02/28","24472","31000","499324","134815","689611"
"2022/02/25","7002","11000","448633","20763","487398"
"2022/02/24","6359","1","637283","20570","664213"
"2022/02/23","10106","9000","266286","41524","326916"
"2022/02/22","41613","8250","527609","76021","653493"
"2022/02/21","11331","31752","724021","316848","1083952"
"2022/02/18","18170","55821","878489","90356","1042836"
"2022/02/17","10","0","337968","87535","425513"
"2022/02/16","60634","0","416218","39686","516538"
"2022/02/15","78","0","265472","49636","315186"
"2022/02/14","1998","0","568783","100071","670852"
"2022/02/11","3766","3001","545128","87008","638903"
"2022/02/10","15451","40","217129","53176","285796"
"2022/02/09","58569","49009","983709","178793","1270080"
"2022/02/08","68006","0","1708979","296641","2073626"
"2022/02/07","1","20","70840","22505","93366"
"2022/02/04","2769","21","87355","6301","96446"
"2022/02/03","3166","4","161336","11301","175807"
"2022/01/28","1010","0","156269","14093","171372"
"2022/01/27","155","1","131692","46971","178819"
"2022/01/26","260","9","135274","60583","196126"
"2022/01/25","13300","0","241450","43540","298290"
"2022/01/24","0","0","130527","27897","158424"
"2022/01/21","200","2","61345","16154","77701"
"2022/01/20","3025","0","102384","4928","110337"
"2022/01/19","3318","0","165402","10998","179718"
"2022/01/18","6227","0","124299","39141","169667"
"2022/01/17","4070","0","98575","43656","146301"
"2022/01/14","50","0","87583","34673","122306"
"2022/01/13","1500","2","120993","13309","135804"
"2022/01/12","30","0","86604","7178","93812"
"2022/01/11","425","0","225394","49409","275228"
"2022/01/10","18600","2","192048","54725","265375"
"2022/01/07","1","2","95519","8910","104432"
"2022/01/06","7","0","155038","12851","167896"
"2022/01/05","20824","8","120050","4307","145189"
"2022/01/04","556","2","133305","8225","142088"
"2022/01/03","2002","0","129916","24198","156116"
"2021/12/30","120","0","123467","41186","164773"
"2021/12/29","6638","0","120825","57791","185254"
"2021/12/28","26542","4","315632","12869","355047"
"2021/12/27","10219","0","234779","43507","288505"
"2021/12/24","25006","0","272105","5412","302523"
"2021/12/23","222","1","189422","38998","228643"
"2021/12/22","3829","0","93525","15735","113089"
"2021/12/21","921","0","191769","24742","217432"
"2021/12/20","6031","0","212326","32690","251047"
"2021/12/17","4777","1","95134","1208","101120"
"2021/12/16","246","0","102416","23710","126372"
"2021/12/15","82","0","83637","9228","92947"
"2021/12/14","1","0","75247","9540","84788"
"2021/12/13","410","33","142671","1770","144884"
"2021/12/10","2001","0","102429","7375","111805"
"2021/12/09","14","0","113187","2554","115755"
"2021/12/08","171","0","126377","15576","142124"
"2021/12/07","7","1","110838","7542","118388"
"2021/12/06","2931","3","116527","22367","141828"
"2021/12/03","1485","38","112896","20558","134977"
"2021/12/02","336",,"163460","22069","185865"
"2021/12/01","27099","0","175853","12364","215316"
"2021/11/30","15969","0","471447","48548","535964"
"2021/11/29","25067","0","277075","27797","329939"
"2021/11/26","7647",,"274682","12666","294995"
"2021/11/25","186","0","132673","3566","136425"
"2021/11/24","4321","0","154478","10549","169348"
"2021/11/23","7727","0","168906","6628","183261"
"2021/11/22","12670","0","208046","22821","243537"
"2021/11/19","15535","1","195196","6015","216747"
"2021/11/18","22018","0","195106","27930","245054"
"2021/11/17","20794","0","417632","20998","459424"
"2021/11/16","12550","0","522032","93984","628566"
"2021/11/15","1120",,"328030","43984","373134"
"2021/11/12","7125","60","316984","30642","354811"
"2021/11/11","21872","0","377585","49867","449324"
"2021/11/10","10116","77","630835","54681","695709"
"2021/11/09","66950","22","1415002","343886","1825860"
"2021/11/08","132990","0","2062471","228959","2424420"
"2021/11/05","6986","2703","331040","25596","366325"
"2021/11/04","1034","0","282774","61529","345337"
"2021/11/03","4053",,"323334","35325","362712"
"2021/11/02","21313","0","435026","38002","494341"
"2021/11/01","15413",,"474141","17885","507439"
"2021/10/29","6313","0","361424","23664","391401"
"2021/10/28","3969",,"224841","21974","250784"
"2021/10/27","26772",,"154632","24615","206019"
"2021/10/26","7378","2400","417447","63694","490919"
"2021/10/25","1820","0","248667","23070","273557"
"2021/10/22","43382","0","372096","71352","486830"
"2021/10/21","3954",,"135435","69251","208640"
"2021/10/20","10243",,"291003","8126","309372"
"2021/10/19","3680",,"164586","2543","170809"
"2021/10/18","7623","0","262282","21315","291220"
"2021/10/15","13325",,"296088","21135","330548"
"2021/10/14","13786",,"238137","24946","276869"
"2021/10/13","24102",,"164732","43037","231871"
"2021/10/12","6778",,"280001","66688","353467"
"2021/10/08","67826",,"544568","149270","761664"
"2021/10/07","31037","1000","913623","206807","1152467"
"2021/10/06","16398",,"747320","200851","964569"
"2021/10/05","32839","5813","457538","103523","599713"
"2021/10/01","6491","6227","518066","52859","583643"
"2021/09/30","13479",,"299015","24748","337242"
"2021/09/29","23383",,"529431","76656","629470"
"2021/09/28","13389","0","558559","50952","622900"
"2021/09/27","23919","500","429909","68231","522559"
"2021/09/24","18489","0","539601","40678","598768"
"2021/09/23","7526","0","1181009","85076","1273611"
"2021/09/17","10929","0","708040","24441","743410"
"2021/09/16","17324","0","769504","87851","874679"
"2021/09/15","23967","0","952236","44866","1021069"
"2021/09/14","59730","1","1147824","154820","1362375"
"2021/09/13","14765",,"1918005","122839","2055609"
"2021/09/10","172596","20039","10808058","819080","11819773"
"2021/09/09","70062","6993","4188335","214477","4479867"
"2021/09/08","109304","39102","5700678","446133","6295217"
"2021/09/07","66440","12500","4865056","251509","5195505"
"2021/09/06","11666","100","1633008","186239","1831013"
"2021/09/03","45497","5111","2653852","166094","2870554"
"2021/09/02","57268","0","2149999","175257","2382524"
"2021/09/01","17112","0","747434","27027","791573"
"2021/08/31","37263","0","1732017","128418","1897698"
"2021/08/30","46306","213","3342336","423879","3812734"
"2021/08/27","118787","0","3016649","294888","3430324"
"2021/08/26","84100","100","3221327","283014","3588541"
"2021/08/25","35813","5","408847","63950","508615"
"2021/08/24","92654","0","1775557","258325","2126536"
"2021/08/23","17601","0","349625","61965","429191"
"2021/08/20","44134","0","384168","123392","551694"
"2021/08/19","25645","0","427734","108885","562264"
"2021/08/18","21292",,"433616","26896","481804"
"2021/08/17","30708","20000","661538","180924","893170"
"2021/08/13","25460","0","429636","153438","608534"
"2021/08/12","57860",,"271099","21505","350464"
"2021/08/11","1","0","470356","38602","508959"
"2021/08/10","15522","656","307186","50446","373810"
"2021/08/09","102295","0","598047","72354","772696"
"2021/08/06","17885",,"229228","12863","259976"
"2021/08/05","5612","0","182318","8933","196863"
"2021/08/04","11214","0","169752","4680","185646"
"2021/08/03","65087",,"374685","157136","596908"
"2021/08/02","4682",,"376056","15733","396471"
"2021/07/30","4392",,"292159","30727","327278"
"2021/07/29","27482","10","416057","35668","479217"
"2021/07/28","25548","0","497282","36498","559328"
"2021/07/27","63289","0","504813","6521","574623"
"2021/07/26","29246","0","227108","84935","341289"
"2021/07/23","16322","0","321844","10215","348381"
"2021/07/22","14235",,"336795","38540","389570"
"2021/07/21","13269","0","289461","111059","413789"
"2021/07/20","29661","0","428930","39270","497861"
"2021/07/19","7579",,"407462","59284","474325"
"2021/07/16","14311","0","571253","7891","593455"
"2021/07/15","15163",,"627699","93758","736620"
"2021/07/14","109330","10000","1853040","41233","2013603"
"2021/07/13","65479","0","1097939","53346","1216764"
"2021/07/12","13650","1000","411072","32057","457779"
"2021/07/09","27092","10000","1151367","43870","1232329"
"2021/07/08","20026","5906","965512","18522","1009966"
"2021/07/07","2510","37557","452450","3923","496440"
"2021/07/06","16486","52000","683352","15062","766900"
"2021/07/05","35279","5000","1021968","83630","1145877"
"2021/07/02","15806","0","886308","36292","938406"
"2021/07/01","102235","31","1448430","341814","1892510"
"2021/06/30","119217","100","2830741","142642","3092700"
"2021/06/29","24947","0","615388","74198","714533"
"2021/06/28","54947",,"880699","84454","1020100"
"2021/06/25","14738","0","675996","50583","741317"
"2021/06/24","37428","0","822889","9415","869732"
"2021/06/23","39838","0","993520","55330","1088688"
"2021/06/22","14027",,"581599","4211","599837"
"2021/06/21","37051","0","772162","28220","837433"
"2021/06/18","28934","5000","1083947","127723","1245604"
"2021/06/17","32191","500","1455927","190163","1678781"
"2021/06/16","18735","0","729013","31113","778861"
"2021/06/15","27654",,"738557","14078","780289"
"2021/06/14","12841","0","782302","22985","818128"
"2021/06/11","24304","0","977859","21565","1023728"
"2021/06/10","51744",,"991814","77924","1121482"
"2021/06/09","36432",,"1145940","59456","1241828"
"2021/06/08","17368","11089","1937882","85155","2051494"
"2021/06/07","35354","29260","1681960","60940","1807514"
"2021/06/04","65864","19000","1110092","17900","1212856"
"2021/06/03","230710","2000","1663443","134003","2030156"
"2021/06/02","109903","0","3244745","160593","3515241"
"2021/06/01","225040","26743","8568066","376388","9196237"
"2021/05/31","319747","263107","10273718","514477","11371049"
"2021/05/28","89793","70","1873010","110057","2072930"
"2021/05/27","447252","295223","6293410","410711","7446596"
"2021/05/26","41070","0","1105743","44591","1191404"
"2021/05/25","40461","1304","712605","94125","848495"
"2021/05/24","44158","0","1155253","128132","1327543"
"2021/05/21","181870","22918","2717841","203964","3126593"
"2021/05/20","88038","30020","3682237","269311","4069606"
"2021/05/18","155057","1191","4132492","289787","4578527"
"2021/05/17","122141","37859","5982712","559344","6702056"
"2021/05/14","70899","2500","647802","44917","766118"
"2021/05/13","37623","2500","1428960","219378","1688461"
"2021/05/12","50843","1000","840271","106450","998564"
"2021/05/11","32271","500","425884","21432","480087"
"2021/05/10","58001","23614","510930","33609","626154"
"2021/05/07","12092","0","368431","20023","400546"
"2021/05/06","3061","0","297323","40555","340939"
"2021/05/04","41873","5000","706537","91966","845376"
"2021/05/03","24559","0","592593","86577","703729"
"2021/04/30","34634","0","1002268","187697","1224599"
"2021/04/29","42036","15000","1619329","147606","1823971"
"2021/04/28","41357","0","975154","93561","1110072"
"2021/04/27","25561","0","785807","82249","893617"
"2021/04/26","36595","0","1728810","91906","1857311"
"2021/04/23","17849","300","857887","64492","940528"
"2021/04/22","31452","640","982914","54022","1069028"
"2021/04/21","121394","15500","4264993","418227","4820114"
"2021/04/20","259746","2258","1149122","74786","1485912"
"2021/04/19","140550","10000","2372260","339219","2862029"
"2021/04/16","91455","30000","4659535","301459","5082449"
"2021/04/15","290406","7137","3727380","245301","4270224"
"2021/04/14","72723","5600","2794378","183708","3056409"
"2021/04/13","206793","0","2968670","161181","3336644"
"2021/04/12","121241","164182","9898706","584555","10768684"
"2021/04/09","154576","196629","12905164","386119","13642488"
"2021/04/08","91369","42500","5323531","378345","5835745"
"2021/04/07","68536","120903","4941969","176513","5307921"
"2021/04/06","81485","10297","4997713","271177","5360672"
"2021/04/05","200268","427292","15045652","933956","16607168"
"2021/04/02","97098","46336","2876960","422030","3442424"
"2021/04/01","44759","400","1123712","51426","1220297"
"2021/03/31","23361","0","801930","59437","884728"
"2021/03/30","7599","0","338737","83719","430055"
"2021/03/29","13846","0","752405","146643","912894"
"2021/03/26","1861","0","339546","21188","362595"
"2021/03/25","611","0","400160","16842","417613"
"2021/03/24","50011","0","588751","81060","719822"
"2021/03/23","80567","0","1303439","320452","1704458"
"2021/03/22","4052","0","246887","53054","303993"
"2021/03/19","41432","0","207818","31490","280740"
"2021/03/18","253","0","340426","41105","381784"
"2021/03/17","6500","0","386009","108839","501348"
"2021/03/16","28821","8683","1058910","174262","1270676"
"2021/03/15","23859","0","617274","132488","773621"
"2021/03/12","23220","24","391063","122765","537072"
"2021/03/11","10674","6854","492569","130399","640496"
"2021/03/10","16243","0","795327","58481","870051"
"2021/03/09","2400","0","820734","123891","947025"
"2021/03/08","2265","3000","476576","74581","556422"
"2021/03/05","163002","0","484823","73390","721215"
"2021/03/04","29316","4200","447825","75752","557093"
"2021/03/03","58781","0","612306","10313","681400"
"2021/03/02","18217","0","864125","37380","919722"
"2021/02/26","4035","0","331060","88132","423227"
"2021/02/25","158508","3","403738","80537","642786"
"2021/02/24","59173","0","668858","140701","868732"
"2021/02/23","31713","0","1172795","77935","1282443"
"2021/02/22","161580","0","1156273","156453","1474306"
"2021/02/19","1081","120","1085896","109673","1196770"
"2021/02/18","3080","48","868118","82948","954194"
"2021/02/17","11716","0","1119906","129085","1260707"
"2021/02/16","14084","150","2042346","147236","2203816"
"2021/02/15","5416","0","1516732","190972","1713120"
"2021/02/10","2194","0","723045","35639","760878"
"2021/02/09","516","0","893182","96094","989792"
"2021/02/08","17670","1000","859241","56142","934053"
"2021/02/05","89","2333","913884","74711","991017"
"2021/02/04","9313","0","699818","56060","765191"
"2021/02/03","3223","0","1487273","140712","1631208"
"2021/02/02","4006","0","787431","52985","844422"
"2021/02/01","2255","0","1349804","70739","1422798"
"2021/01/29","4020","0","2136950","133848","2274818"
"2021/01/28","27889","308700","14393856","437927","15168372"
"2021/01/27","1302","0","1547859","68859","1618020"
"2021/01/26","61497","12646","5245833","281167","5601143"
"2021/01/25","164073","357672","13215613","494843","14232201"
"2021/01/22","11856","35295","682855","75197","805203"
"2021/01/21","1104","62005","2049793","235108","2348010"
"2021/01/20","12849","0","1105004","50609","1168462"
"2021/01/19","57520","114190","4253531","565684","4990925"
"2021/01/18","27165","312240","4602391","293569","5235365"
"2021/01/15","11213","54077","553269","35402","653961"
"2021/01/14","198","68183","527043","43049","638473"
"2021/01/13","164","0","352543","3391","356098"
"2021/01/12","7627","0","284323","27564","319514"
"2021/01/11","33824","36554","1870077","310047","2250502"
"2021/01/08","11265","0","677132","20446","708843"
"2021/01/07","0","5576","410298","19395","435269"
"2021/01/06","846","10000","305594","19153","335593"
"2021/01/05","0","13000","436917","38080","487997"
"2021/01/04","579","0","452613","38113","491305"
"2020/12/30","55643","1113","276071","35123","367950"
"2020/12/29","1189","5000","307247","11741","325177"
"2020/12/28","28179","0","572412","17431","618022"
"2020/12/24","151","1750380","216536","11895","1978962"
"2020/12/23","688","150","493040","27108","520986"
"2020/12/22","324","0","799531","33619","833474"
"2020/12/21","2536","0","577119","2834","582489"
"2020/12/18","301","7000","678538","47420","733259"
"2020/12/17","176","10300","1471418","90533","1572427"
"2020/12/16","54295","80100","4168279","278586","4581260"
"2020/12/15","19499","0","472317","18494","510310"
"2020/12/14","42514","8353","542330","24827","618024"
"2020/12/11","29355","12812","422036","16209","480412"
"2020/12/10","1900","0","326743","865","329508"
"2020/12/09","55","0","269286","2554","271895"
"2020/12/08","6920","0","659926","27749","694595"
"2020/12/07","10337","3000","560962","26499","600798"
"2020/12/04","51373","2000","1675959","111084","1840416"
"2020/12/03","635","0","365682","2885","369202"
"2020/12/02","136","0","231277","3903","235316"
"2020/12/01","217","0","183746","777","184740"
"2020/11/30","64","5096","276777","6505","288442"
"2020/11/27","73","20000","159723","0","179796"
"2020/11/26","5979","444","199515","3056","208994"
"2020/11/25","660","0","813336","16052","830048"
"2020/11/24","43239","39322","1329835","74414","1486810"
"2020/11/23","66793","0","1277984","47948","1392725"
"2020/11/20","512","0","153054","27635","181201"
"2020/11/19","34411","1000","325409","24485","385305"
"2020/11/18","223729","0","651350","41678","916757"
"2020/11/17","73670","3010","643854","11183","731717"
"2020/11/16","175615","0","1020709","29282","1225606"
"2020/11/13","198062","50788","3271004","72704","3592558"
"2020/11/12","1000557","50000","4250826","49949","5351332"
"2020/11/11","40691","61461","4208241","186367","4496760"
"2020/11/10","7093","0","159333","3529","169955"
"2020/11/09","26","0","180861","5787","186674"
"2020/11/06","15","0","114196","6915","121126"
"2020/11/05","32","0","114328","3750","118110"
"2020/11/04","724","9948","75335","1899","87906"
"2020/11/03","2592","0","100118","385","103095"
"2020/11/02","2340","0","118242","0","120582"
"2020/10/30","2064","0","372340","2677","377081"
"2020/10/29","15180","0","407270","3455","425905"
"2020/10/28","0","0","150910","1286","152196"
"2020/10/27","10001","0","118031","2494","130526"
"2020/10/26","8","905","200917","5935","207765"
"2020/10/23","291","17746","156603","2675","177315"
"2020/10/22","2487","0","50105","853","53445"
"2020/10/21","2983","60000","155378","4076","222437"
"2020/10/20","2555","0","110388","1910","114853"
"2020/10/19","14","104600","265007","2490","372111"
"2020/10/16","3083","0","660434","24116","687633"
"2020/10/15","2007","1005","475996","24094","503102"
"2020/10/14","281","0","110767","2329","113377"
"2020/10/13","7","0","166007","5842","171856"
"2020/10/12","1088","0","266884","18284","286256"
"2020/10/08","2","0","135655","1271","136928"
"2020/10/07","3","0","27778","916","28697"
"2020/10/06","5","0","46949","8585","55539"
"2020/10/05","1922","0","30272","12643","44837"
"2020/09/29","13","0","53499","1954","55466"
"2020/09/28","5","0","22840","872","23717"
"2020/09/25","0","0","36374","1320","37694"
"2020/09/24","2663","0","56947","2998","62608"
"2020/09/23","2618","0","96670","4427","103715"
"2020/09/22","0","1001","190725","23931","215657"
"2020/09/21","1","0","240480","3990","244471"
"2020/09/18","74","0","79136","506","79716"
"2020/09/17","2","0","63256","3416","66674"
"2020/09/16","5282","90000","166136","1791","263209"
"2020/09/15","6692","0","193664","2409","202765"
"2020/09/14","4","0","138513","0","138517"
"2020/09/11","8","0","64123","100","64231"
"2020/09/10","14","0","102673","3758","106445"
"2020/09/09","482","1000","157380","15022","173884"
"2020/09/08","4100","0","177673","4723","186496"
"2020/09/07","49","0","213519","3949","217517"
"2020/09/04","9","0","171191","4602","175802"
"2020/09/03","11","1000","150130","4092","155233"
"2020/09/02","16","10","98694","2275","100995"
"2020/09/01","17","0","277937","15658","293612"
"2020/08/31","2","0","106941","6960","113903"
"2020/08/28","25","0","72384","1000","73409"
"2020/08/27","5","600","83964","0","84569"
"2020/08/26","4","0","61405","2984","64393"
"2020/08/25","19772",,"51564","6175","77511"
"2020/08/24","8","0","60061","1182","61251"
"2020/08/21","5","0","201737","796","202538"
"2020/08/20","7","0","269731","4393","274131"
"2020/08/19","2732","4555","117142","3715","128144"
"2020/08/18","6320","0","311831","5933","324084"
"2020/08/14","8","0","107043","4149","111200"
"2020/08/13","8","100","113773","5343","119224"
"2020/08/12","18","0","79200","3430","82648"
"2020/08/11","50","0","66736","471","67257"
"2020/08/10","161","0","96152","535","96848"
"2020/08/07","8","0","90059","1966","92033"
"2020/08/06","10","0","28397","0","28407"
"2020/08/05","63","1000","70264","3500","74827"
"2020/08/04","1139","0","49282","591","51012"
"2020/08/03","4736","0","226837","712","232285"
"2020/07/31","0","0","78340","2823","81163"
"2020/07/30","36","0","138784","0","138820"
"2020/07/29","100","4000","42996","0","47096"
"2020/07/28","1","1000","131266","0","132267"
"2020/07/27","1","0","162068","0","162069"
"2020/07/24","198","2000","101576","348","104122"
"2020/07/23","2461","0","77293","0","79754"
"2020/07/22","1","0","52149","7084","59234"
"2020/07/21","3","0","120267","510","120780"
"2020/07/20","16001","0","52367","7783","76151"
"2020/07/17","802","0","56478","0","57280"
"2020/07/16","37","10250","68109","0","78396"
"2020/07/15","1954","0","83273",,"85227"
"2020/07/14","8428","0","55518",,"63946"
"2020/07/13","26","0","196397","4990","201413"
"2020/07/10","15487","0","1473193","83192","1571872"
"2020/07/09","24848","0","424384","0","449232"
"2020/07/08","2473","0","38707","0","41180"
"2020/07/07","181","0","74725",,"74906"
"2020/07/06","2829","0","101653",,"104482"
"2020/07/03","5","0","21234",,"21239"
"2020/07/02","3","0","36448","0","36451"
"2020/07/01","78","0","42521","0","42599"
"2020/06/30","8","0","90215",,"90223"
"2020/06/29","2078","0","144094","0","146172"
"2020/06/26","1255","0","40346","0","41601"
"2020/06/25","23","0","72002","3632","75657"
"2020/06/24","2665","4","92652","0","95321"
"2020/06/23","6","0","21824",,"21830"
"2020/06/22","2","0","52505",,"52507"
"2020/06/19","2","0","62740","875","63617"
"2020/06/18","2656","0","58893","0","61549"
"2020/06/17","8","451","238731","5616","244806"
"2020/06/16","3999","0","284690","785","289474"
"2020/06/15","8731","0","154510","4000","167241"
"2020/06/12","8021","0","270727","4242","282990"
"2020/06/11","9501","2760","153465","0","165726"
"2020/06/10","8984","0","174491","6398","189873"
"2020/06/09","21","0","166289","0","166310"
"2020/06/08","11","0","112525","3628","116164"
"2020/06/05","113",,"180551","0","180664"
"2020/06/04","47","0","121450","0","121497"
"2020/06/03","1838",,"182927","2452","187217"
"2020/06/02","600","0","162741","4024","167365"
"2020/06/01","0","0","118581","72","118653"
"2020/05/29","0","0","113875","0","113875"
"2020/05/28","5776","0","240724","4104","250604"
"2020/05/27","0","1000","119102","13198","133300"
"2020/05/26","7189","0","82597","8732","98518"
"2020/05/25","0","0","39103","6403","45506"
"2020/05/22","10","0","106792","13501","120303"
"2020/05/21","820","3000","204181","3309","211310"
"2020/05/20","1","225","92713","272","93211"
"2020/05/19","489","3124","147642","4595","155850"
"2020/05/18","251","0","138305","4819","143375"
"2020/05/15","20008","0","165728","12677","198413"
"2020/05/14","13796","0","137536","4009","155341"
"2020/05/13","189","0","117723","3347","121259"
"2020/05/12","34","0","126183","26297","152514"
"2020/05/11","30","1000","145399","14272","160701"
"2020/05/08","396","0","150862","5700","156958"
"2020/05/07","523","0","123424","6159","130106"
"2020/05/06","5000","580","182463","11325","199368"
"2020/05/04","0","0","130380","10256","140636"
"2020/04/29","10736","0","359373","12058","382167"
"2020/04/28","11815","0","340366","0","352181"
"2020/04/27","150","6204","163201","5895","175450"
"2020/04/24","43","0","111039","20914","131996"
"2020/04/23","5493","0","113554","4930","123977"
"2020/04/22","2252","0","203698","7490","213440"
"2020/04/21","11801","1220","402960","58962","474943"
"2020/04/20","2519","0","173104","4417","180040"
"2020/04/17","5558","0","305627","0","311185"
"2020/04/16","1","0","465967","10855","476823"
"2020/04/14","14486","0","324490","22591","361567"
"2020/04/13","5023","0","233358","10766","249147"
"2020/04/10","35","441","319671","30244","350391"
"2020/04/09","11634",,"200494","10781","222909"
"2020/04/08","7129","2250","179911","2034","191324"
"2020/04/07","5000","0","200232","22382","227614"
"2020/04/06","6720","0","398796","414","405930"
"2020/04/03","15887","0","117103","245","133235"
"2020/04/02","0","0","169179","15950","185129"
"2020/04/01","5442","0","254964","10094","270500"
"2020/03/31","3141","0","140667","3428","147236"
"2020/03/30","9929","0","126027","2727","138683"
"2020/03/27","8678","7118","175176","24434","215406"
"2020/03/26","35326","0","166443","25638","227407"
"2020/03/25","40905","0","108014","18082","167001"
"2020/03/24","23282","2","104853","24878","153015"
"2020/03/23","11724","40001","219859","37023","308607"
"2020/03/20","53668","0","183244","5864","242776"
"2020/03/19","0","0","925737","92291","1018028"
"2020/03/18","26689","0","167811","24517","219017"
"2020/03/17","10917","0","248610","59315","318842"
"2020/03/16","3721","0","115648","6575","125944"
"2020/03/13","125435","1773","717727","133230","978165"
"2020/03/12","25745","0","383666","115779","525190"
"2020/03/11","36210","0","339926","49286","425422"
"2020/03/10","3891","188","172533","66014","242626"
"2020/03/09","20027","0","157763","93792","271582"
"2020/03/06","6377","7800","166090","37445","217712"
"2020/03/05","25418","0","219159","5002","249579"
"2020/03/04","15388","2475","139598","22808","180269"
"2020/03/03","6752","0","103878","42518","153148"
"2020/03/02","16677","1","183693","75598","275969"
"2020/02/28","32058","0","420888","95776","548722"
"2020/02/27","30633","0","187183","35222","253038"
"2020/02/26","18410","0","168405","43730","230545"
"2020/02/25","26444","0","166038","18844","211326"
"2020/02/24","9933","0","639893","93445","743271"
"2020/02/21","13333","2000","320638","43520","379491"
"2020/02/20","7452","0","134834","30834","173120"
"2020/02/19","571","0","130028","21015","151614"
"2020/02/18","2692","0","116368","2428","121488"
"2020/02/17","7730","0","170028","661","178419"
"2020/02/14","0","0","471421","14003","485424"
"2020/02/13","18380","0","254568","13495","286443"
"2020/02/12","19484","0","296435","12257","328176"
"2020/02/11","9444","12580","323080","31241","376345"
"2020/02/10","23517","124307","839417","41816","1029057"
"2020/02/07","358","0","316842","10252","327452"
"2020/02/06","13450","0","163036","15214","191700"
"2020/02/05","25726","0","238332","3180","267238"
"2020/02/04","21960","0","139627","14094","175681"
"2020/02/03","24739","0","343237","45978","413954"
"2020/01/31","34075","0","376403","22438","432916"
"2020/01/30","31968","0","280221","22362","334551"
"2020/01/29","9496","0","157210","39519","206225"
"2020/01/28","0","1000","577898","46990","625888"
"2020/01/23","0","645","133428","12991","147064"
"2020/01/22","1971","8000","152692","6519","169182"
"2020/01/21","1887","1000","186247","31411","220545"
"2020/01/20","22737","20000","389236","18463","450436"
"2020/01/17","6472","0","384192","9719","400383"
"2020/01/16","27338","18003","1343009","200208","1588558"
"2020/01/15","4849","73000","457982","13560","549391"
"2020/01/14","14791","5010","318802","26890","365493"
"2020/01/13","25721","0","280688","11675","318084"
"2020/01/10","14542","0","266093","27859","308494"
"2020/01/09","9257","0","397456","11628","418341"
"2020/01/08","26542","0","775104","40782","842428"
"2020/01/07","24450","0","293825","8090","326365"
"2020/01/06","31859","5695","533667","26895","598116"
"2020/01/03","16782","4420","475245","5510","501957"
"2020/01/02","0","10000","362964","18172","391136"
"2019/12/30","4323","0","273295","1593","279211"
"2019/12/27","40921","0","973224","6860","1021005"
"2019/12/26","58174","0","1288400","16148","1362722"
"2019/12/24","0","0","462689","11555","474244"
"2019/12/23","29367","0","536767","74041","640175"
"2019/12/20","16145","0","809588","59129","884862"
"2019/12/19","41181","3205","1993743","19939","2058068"
"2019/12/18","28480","1760","1482930","55979","1569149"
"2019/12/17","52364","246115","7339502","416866","8054847"
"2019/12/16","0","0","157449","0","157449"
"2019/12/13","8280","0","246966","4455","259701"
"2019/12/12","32112","0","1478811","227453","1738376"
"2019/12/11","8576","0","192424","4551","205551"
"2019/12/10","4353","34000","212213","1161","251727"
"2019/12/09","3035","40498","63713","10490","117736"
"2019/12/06","20254","40502","401675","2538","464969"
"2019/12/05","12907","0","304462","506","317875"
"2019/12/04","700","0","166709",,"167409"
"2019/12/03","2000","0","59316","2198","63514"
"2019/12/02","5289","10000","89337",,"104626"
"2019/11/29","4483","0","182074","4047","190604"
"2019/11/28","2026","0","211477","1559","215062"
"2019/11/27","37","0","112381",,"112418"
"2019/11/26","35593","0","130914","14","166521"
"2019/11/25","17473","2000","170324","1","189798"
"2019/11/22","200","0","99098","16105","115403"
"2019/11/21","20901","0","392246","444","413591"
"2019/11/20","14198","0","250024","407","264629"
"2019/11/19","28578","0","207678","4640","240896"
"2019/11/18","57250","1031","256911","35595","350787"
"2019/11/15","17123","0","221157","4881","243161"
"2019/11/14","137702","0","575427","8045","721174"
"2019/11/13","53487","0","380010","1548","435045"
"2019/11/12","7000","4764","252533","20932","285229"
"2019/11/11","10029","10000","240069","2277","262375"
"2019/11/08","7541","10000","179191","2682","199414"
"2019/11/07","36875","0","332743","11342","380960"
"2019/11/06","7028","5000","109244","0","121272"
"2019/11/05","8792","890","260550","0","270232"
"2019/11/04","9232","4110","116352","0","129694"
"2019/11/01","4471","0","172300","1191","177962"
"2019/10/31","4137","7000","225055","1734","237926"
"2019/10/30","26371","0","951547","58191","1036109"
"2019/10/29","732","3000","116833","867","121432"
"2019/10/28","0","3000","90209","2461","95670"
"2019/10/25","1429","1000","95617","3055","101101"
"2019/10/24","5874","3000","68429","177","77480"
"2019/10/23","3297","0","215986","17628","236911"
"2019/10/22","8854","1002","82142",,"91998"
"2019/10/21","1827","0","132093","18346","152266"
"2019/10/18","13759","0","157637","29524","200920"
"2019/10/17","36294","0","587946","2408","626648"
"2019/10/16","4382","0","68133","9203","81718"
"2019/10/15","46357","0","342745","3879","392981"
"2019/10/14","6883","0","42111","4280","53274"
"2019/10/11","24423","0","127834","5701","157958"
"2019/10/10","4420","0","107542","18865","130827"
"2019/10/08","21176","0","71849","3235","96260"
"2019/10/07","9833","2","58763","10262","78860"
"2019/10/04","8753","0","58034","144","66931"
"2019/10/02","900","0","54211","6586","61697"
"2019/10/01","4607","0","122280","16382","143269"
"2019/09/30","4360","0","93351","7","97718"
"2019/09/27","3764","0","64579","7211","75554"
"2019/09/26","500","0","142630","1372","144502"
"2019/09/25","12261","1000","111460","15351","140072"
"2019/09/24","6830","1000","75992","14107","97929"
"2019/09/23","5156","1000","95636","18711","120503"
"2019/09/20","15054","0","153786","2037","170877"
"2019/09/19","5561","0","138660","9908","154129"
"2019/09/18","36125","0","168849","15199","220173"
"2019/09/17","50664","0","1034052","10546","1095262"
"2019/09/16","40716","0","216025","4072","260813"
"2019/09/11","10162","0","259012","31245","300419"
"2019/09/10","140427","19284","9930836","65616","10156163"
"2019/09/09","8487","20716","701428","17149","747780"
"2019/09/06","12697","0","166368","14986","194051"
"2019/09/05","4772","0","550343","60146","615261"
"2019/09/04","22330","0","76461","9413","108204"
"2019/09/03","12756","0","221969","4353","239078"
"2019/09/02","20979","0","80512","3810","105301"
"2019/08/30","21026","0","83404","9905","114335"
"2019/08/29","30703","0","150912","33751","215366"
"2019/08/28","25387","0","100791","12212","138390"
"2019/08/27","14894","0","42027","11797","68718"
"2019/08/26","272","0","52693","14751","67716"
"2019/08/23","36902","0","657816","62030","756748"
"2019/08/22","27682","1000","241251","5783","275716"
"2019/08/21","13254","1006","285430","22260","321950"
"2019/08/20","32677","1000","599935","70475","704087"
"2019/08/19","42593","0","633668","69822","746083"
"2019/08/16","14507","0","113127","18349","145983"
"2019/08/14","4955",,"28514","6401","39870"
"2019/08/13","11663","0","51699","10335","73697"
"2019/08/12","20982",,"87424","7054","115460"
"2019/08/09","7104","0","64150","18194","89448"
"2019/08/08","8284","0","87855","9327","105466"
"2019/08/07","30704","0","152267","18938","201909"
"2019/08/06","2238","0","173003","24727","199968"
"2019/08/05","15874","0","366857","16012","398743"
"2019/08/02","2906","0","70168","38053","111127"
"2019/08/01","14558","0","85809","20168","120535"
"2019/07/31","8161","0","79486","12673","100320"
"2019/07/30","17398","0","194801","12541","224740"
"2019/07/29","12","520","328094","36388","365014"
"2019/07/26","490","0","86682","22618","109790"
"2019/07/25","0","0","164504","22350","186854"
"2019/07/24","6512","0","105541","19105","131158"
"2019/07/23","11775","0","81594","7142","100511"
"2019/07/22","12839","0","103655","3764","120258"
"2019/07/19","440","0","157907","3877","162224"
"2019/07/18","548","0","87610","15887","104045"
"2019/07/17","17196","180","520679","100655","638710"
"2019/07/16","2","0","98225","10379","108606"
"2019/07/15","8408","0","52604","7397","68409"
"2019/07/12","5021","32","140206","283","145542"
"2019/07/11","4417","32","49463","8164","62076"
"2019/07/10","1068","0","73389","8674","83131"
"2019/07/09","11226","190","186173","39267","236856"
"2019/07/08","0","190","208194","3020","211404"
"2019/07/05","5069","0","205004","3479","213552"
"2019/07/04","0","0","153695","10746","164441"
"2019/07/03","2871","0","130845","2142","135858"
"2019/07/02","732","0","44074","4535","49341"
"2019/07/01","13612","0","133825","4611","152048"
"2019/06/28","3413","0","122353","14311","140077"
"2019/06/27","28","0","155192","28200","183420"
"2019/06/26","11173","0","121425","2539","135137"
"2019/06/25","11799","0","140248","78400","230447"
"2019/06/24","6736","0","148061","0","154797"
"2019/06/21","10214","0","139497","7549","157260"
"2019/06/20","0","0","208427","3819","212246"
"2019/06/19","766","0","72865","1868","75499"
"2019/06/18","8335","0","217550","3761","229646"
"2019/06/17","12816","0","194611","2609","210036"
"2019/06/14","12118","1","172604","1414","186137"
"2019/06/13","0","0","129959","19787","149746"
"2019/06/12","12851","0","467150","46304","526305"
"2019/06/11","0","0","148511","3826","152337"
"2019/06/10","0","0","116899","2727","119626"
"2019/06/07","5794","0","151016","2428","159238"
"2019/06/05","13720","0","104336","9330","127386"
"2019/06/04","0","0","288393","19609","308002"
"2019/06/03","1146","0","186387","4830","192363"
"2019/05/31","4440","0","239648","1373","245461"
"2019/05/30","0","0","220053","11319","231372"
"2019/05/29","0","0","124012","19550","143562"
"2019/05/28","6992","0","106572","3189","116753"
"2019/05/27","2271","0","66882","3","69156"
"2019/05/24","4483","1000","179930","8464","193877"
"2019/05/23","6244","0","170735","25772","202751"
"2019/05/22","488","0","150321","7112","157921"
"2019/05/21","4406","0","138928","15339","158673"
"2019/05/20","11496","0","169057","17717","198270"
"2019/05/17","978","0","158283","32326","191587"
"2019/05/16","11325","0","306657","4580","322562"
"2019/05/15","3765","0","112794","10455","127014"
"2019/05/14","7693","0","181441","4094","193228"
"2019/05/13","5430","0","140438","4088","149956"
"2019/05/10","0","0","231045","21333","252378"
"2019/05/09","2497","0","440252","41288","484037"
"2019/05/08","540",,"116064","4628","121232"
"2019/05/07","0","3748","153966","809","158523"
"2019/05/03","0",,"107396","738","108134"
"2019/05/02","6552","0","199955","3548","210055"
"2019/04/30","9965","0","221799","18845","250609"
"2019/04/29","9797","0","120238","2736","132771"
"2019/04/26","54567","580","576849","1683","633679"
"2019/04/25","3480",,"230585","34099","268164"
"2019/04/24","12551","0","176196","7833","196580"
"2019/04/23","15754",,"516754","21068","553576"
"2019/04/22","10288",,"259851","1352","271491"
"2019/04/19","8079","0","280806","17241","306126"
"2019/04/18","17309","0","257196","42944","317449"
"2019/04/17","23168","880","740462","7740","772250"
"2019/04/16","0","0","322446","17983","340429"
"2019/04/15","13596","0","289617","15878","319091"
"2019/04/12","27","3","263999","23055","287084"
"2019/04/11","8186","0","149528","3977","161691"
"2019/04/10","16973","0","172079","1864","190916"
"2019/04/09","0","9200","186226","11459","206885"
"2019/04/08","3792","300","185765","15296","205153"
"2019/04/05","12413","0","194692","15561","222666"
"2019/04/04","28689","0","532503","60671","621863"
"2019/04/03","12183","0","208160","2121","222464"
"2019/04/02","3273","0","232327","7320","242920"
"2019/04/01","5123","0","231705","9","236837"
"2019/03/29","33055","0","228797","9738","271590"
"2019/03/28","0","1011","227902","11198","240111"
"2019/03/27","5197","1007","213051","8087","227342"
"2019/03/26","4262","0","130919","6368","141549"
"2019/03/25","6138","0","218199","31043","255380"
"2019/03/22","4894","0","296846","14953","316693"
"2019/03/21","12521","0","276041","23553","312115"
"2019/03/20","27637","0","358408","41556","427601"
"2019/03/19","8435","0","219702","14908","243045"
"2019/03/18","131",,"189972","6415","196518"
"2019/03/15","122","0","339660","55639","395421"
"2019/03/14","17681","0","207269","1162","226112"
"2019/03/13","15921",,"134828","9487","160236"
"2019/03/12","16465","200","225042","7580","249287"
"2019/03/11","5249",,"312141","9219","326609"
"2019/03/08","42545",,"317597","41124","401266"
"2019/03/07","19415",,"326609","36464","382488"
"2019/03/06","5131",,"224421","12451","242003"
"2019/03/05","25828","200","255685","11421","293134"
"2019/03/04","11681",,"220238","5648","237567"
"2019/02/28","4600","0","1078723","170404","1253727"
"2019/02/27","14200",,"400369","5425","419994"
"2019/02/26","17054","554","1219644","97582","1334834"
"2019/02/25","18498","0","1125727","43288","1187513"
"2019/02/22","10915","0","700371","67767","779053"
"2019/02/21","80",,"776397","57595","834072"
"2019/02/20","0",,"434492","32132","466624"
"2019/02/19","4530",,"1195475","52970","1252975"
"2019/02/18","0",,"831668","19034","850702"
"2019/02/15","0","1000","1001541","77568","1080109"
"2019/02/14","0","1000","671888","109977","782865"
"2019/02/13","0","0","1291191","83214","1374405"
"2019/02/12","3961","0","675326","125834","805121"
"2019/02/11","2021",,"1199177","20403","1221601"
"2019/02/08","7952","0","761434","10972","780358"
"2019/02/07","10944",,"1355050","59801","1425795"
"2019/02/01","0","0","833848","45070","878918"
"2019/01/31","0","4040","1243179","58934","1306153"
"2019/01/30","7323","4000","1465327","122431","1599081"
"2019/01/29","0","0","1466698","45480","1512178"
"2019/01/28","3653",,"1593157","25101","1621911"
"2019/01/25","0",,"634912","46617","681529"
"2019/01/24","0",,"370118","15377","385495"
"2019/01/23","3244","0","322284","31262","356790"
"2019/01/22","0",,"935717","40620","976337"
"2019/01/21","0","0","419460","33351","452811"
"2019/01/18","0",,"546467","40178","586645"
"2019/01/17","3556",,"802859","10439","816854"
"2019/01/16","10453",,"1051791","28660","1090904"
"2019/01/15","3279",,"861344","33868","898491"
"2019/01/14","3348",,"1262556","69756","1335660"
"2019/01/11","9891","7","754008","16853","780759"
"2019/01/10","2170","0","1039883","35407","1077460"
"2019/01/09","194","200000","543882","63086","807162"
"2019/01/08","750","0","2064956","123321","2189027"
"2019/01/07","1461",,"2439917","138773","2580151"
"2019/01/04","0",,"1669496","56999","1726495"
"2019/01/03","0","0","724016","55865","779881"
"2019/01/02","0",,"844771","46900","891671"