일자,기관 합계,기타법인,개인,외국인 합계,전체
"2023/05/04","91551","2023","147010","9613","250197"
"2023/05/03","43828","43269","177598","8135","272830"
"2023/05/02","28524","98460","193810","7027","327821"
"2023/04/28","26287","22278","112700","92837","254102"
"2023/04/27","49325","77849","82165","31771","241110"
"2023/04/26","43654","20006","174619","48382","286661"
"2023/04/25","35665","105","220017","22061","277848"
"2023/04/24","93922","15508","215428","2427","327285"
"2023/04/21","97852","191","319166","2148","419357"
"2023/04/20","62970","2","196794","43674","303440"
"2023/04/19","79774","221","236007","16425","332427"
"2023/04/18","58955","4600","196745","83342","343642"
"2023/04/17","74891","352","120703","50688","246634"
"2023/04/14","69091","37078","251008","199054","556231"
"2023/04/13","77638","0","180214","34487","292339"
"2023/04/12","47443","18106","93415","22163","181127"
"2023/04/11","70933","21000","125776","32694","250403"
"2023/04/10","76400","10279","158271","11559","256509"
"2023/04/07","22030","7280","70654","12904","112868"
"2023/04/06","71090","22","84392","13140","168644"
"2023/04/05","100054","10001","112435","4924","227414"
"2023/04/04","45320","13756","74744","72467","206287"
"2023/04/03","110152","8465","75703","46234","240554"
"2023/03/31","134480","1690","93607","75995","305772"
"2023/03/30","67974","5001","120796","8409","202180"
"2023/03/29","81458","13090","80927","1439","176914"
"2023/03/28","33905","12313","146588","46106","238912"
"2023/03/27","112129","86572","349139","38576","586416"
"2023/03/24","21161","0","148156","12967","182284"
"2023/03/23","51137","14760","171601","35303","272801"
"2023/03/22","102827","10123","187865","390","301205"
"2023/03/21","67514","7398","184180","33280","292372"
"2023/03/20","27739","20000","145311","8563","201613"
"2023/03/17","63068","37596","91936","140869","333469"
"2023/03/16","44089","37018","49872","11833","142812"
"2023/03/15","50937","80211","91337","10339","232824"
"2023/03/14","92365","3420","210258","31487","337530"
"2023/03/13","57739","5003","216545","64877","344164"
"2023/03/10","148081","7850","198554","2678","357163"
"2023/03/09","36274","0","143226","2881","182381"
"2023/03/08","39756","1810","155167","3011","199744"
"2023/03/07","73242","3000","161626","47920","285788"
"2023/03/06","88823","5060","119441","32264","245588"
"2023/03/03","45664","443","113181","2977","162265"
"2023/03/02","73408","2915","258582","19105","354010"
"2023/02/28","51098","24593","169655","43191","288537"
"2023/02/27","35426","5052","159791","40925","241194"
"2023/02/24","58846","0","55943","18086","132875"
"2023/02/23","65345","15","108875","3203","177438"
"2023/02/22","42247","26","63781","3027","109081"
"2023/02/21","34603","313","88960","8354","132230"
"2023/02/20","33404","44278","105686","32009","215377"
"2023/02/17","25285","1","84163","20690","130139"
"2023/02/16","78731","732","138032","16389","233884"
"2023/02/15","51294","4007","111981","978","168260"
"2023/02/14","64898","3","159808","9011","233720"
"2023/02/13","43611","5986","274113","11164","334874"
"2023/02/10","29960","31","103788","4066","137845"
"2023/02/09","11554","380","97318","17540","126792"
"2023/02/08","30352","0","79855","23214","133421"
"2023/02/07","52604","33125","87293","2601","175623"
"2023/02/06","77637","136","138847","16774","233394"
"2023/02/03","74379","3180","164894","143217","385670"
"2023/02/02","94313","225","117798","68628","280964"
"2023/02/01","36657","0","198951","16724","252332"
"2023/01/31","120531","3002","234817","33708","392058"
"2023/01/30","68810","21502","171797","47828","309937"
"2023/01/27","93720","33859","324062","43412","495053"
"2023/01/26","60521","18819","346370","24936","450646"
"2023/01/25","70318","106960","357354","29584","564216"
"2023/01/20","80307","40002","136301","30326","286936"
"2023/01/19","89925","1611","163923","30802","286261"
"2023/01/18","115060","199","156695","29957","301911"
"2023/01/17","117537","200","130342","43330","291409"
"2023/01/16","112102","1225","242509","107098","462934"
"2023/01/13","95422","201","153384","110728","359735"
"2023/01/12","68838","1","111337","84127","264303"
"2023/01/11","89728","3002","113019","36552","242301"
"2023/01/10","59502","36936","147573","74005","318016"
"2023/01/09","68444","38895","174208","51215","332762"
"2023/01/06","92117","1001","138413","75090","306621"
"2023/01/05","42697","102","144822","2768","190389"
"2023/01/04","26807","3","118368","11755","156933"
"2023/01/03","42262","80295","119168","12242","253967"
"2023/01/02","30564","33054","96152","19867","179637"
"2022/12/29","32300","5850","159534","2992","200676"
"2022/12/28","89478","14646","428755","59826","592705"
"2022/12/27","282374","40105","462849","16911","802239"
"2022/12/26","322315","27962","283674","17839","651790"
"2022/12/23","147975","2","113167","49516","310660"
"2022/12/22","286501","1","102000","141142","529644"
"2022/12/21","168066","21601","190907","42570","423144"
"2022/12/20","171171","10501","262345","18045","462062"
"2022/12/19","111859","4551","113475","35390","265275"
"2022/12/16","152056","9041","136768","222940","520805"
"2022/12/15","163667","29305","73726","24991","291689"
"2022/12/14","152367","7145","174360","40456","374328"
"2022/12/13","93203","4","125216","8498","226921"
"2022/12/12","69198","1","80993","27599","177791"
"2022/12/09","117084","17","69996","20900","207997"
"2022/12/08","51036","2191","97673","9168","160068"
"2022/12/07","30753","1242","112052","13440","157487"
"2022/12/06","121426","2500","113314","30678","267918"
"2022/12/05","50164","5538","130511","1908","188121"
"2022/12/02","60018","2953","92197","34655","189823"
"2022/12/01","144683","1142","160287","113881","419993"
"2022/11/30","26131","1470","100141","88300","216042"
"2022/11/29","23782","666","71930","8033","104411"
"2022/11/28","54608","65231","112901","51356","284096"
"2022/11/25","25367","9229","95140","47991","177727"
"2022/11/24","51424","6084","123236","15282","196026"
"2022/11/23","25167","2950","130002","21091","179210"
"2022/11/22","37431","15058","160660","4310","217459"
"2022/11/21","88923","4000","170081","7328","270332"
"2022/11/18","59129","5238","165480","23860","253707"
"2022/11/17","27976","235","134035","33334","195580"
"2022/11/16","20526","43418","152753","60076","276773"
"2022/11/15","44582","700","175086","15211","235579"
"2022/11/14","102512","1082","185071","40236","328901"
"2022/11/11","178088","27131","416632","61379","683230"
"2022/11/10","22267","3957","146467","44532","217223"
"2022/11/09","32345","13000","123583","58258","227186"
"2022/11/08","47487","4125","329342","8185","389139"
"2022/11/07","34247","10515","214979","59399","319140"
"2022/11/04","53384","4718","275998","21710","355810"
"2022/11/03","33682","5002","324179","71876","434739"
"2022/11/02","79086","17782","423517","96136","616521"
"2022/11/01","128707","10","248576","20244","397537"
"2022/10/31","53799","1865","227721","297161","580546"
"2022/10/28","66403","3524","289003","11865","370795"
"2022/10/27","178089","6519","375861","90272","650741"
"2022/10/26","149729","4144","234395","31301","419569"
"2022/10/25","115997","0","215497","22780","354274"
"2022/10/24","111315","10232","358170","70299","550016"
"2022/10/21","145775","19255","663016","14030","842076"
"2022/10/20","156216","21304","766270","35657","979447"
"2022/10/19","114906","34602","687878","92983","930369"
"2022/10/18","236065","38640","567664","66173","908542"
"2022/10/17","221856","35011","603706","71397","931970"
"2022/10/14","105265","3430","280823","17045","406563"
"2022/10/13","60231","366932","296684","187695","911542"
"2022/10/12","45369","117251","197692","3097","363409"
"2022/10/11","66616","56470","256871","22390","402347"
"2022/10/07","52754","40292","86236","220275","399557"
"2022/10/06","89502","20100","180157","210731","500490"
"2022/10/05","36192","34","100501","185479","322206"
"2022/10/04","72467","7588","108706","210175","398936"
"2022/09/30","64112","17470","95627","594124","771333"
"2022/09/29","86873","1230","207104","48418","343625"
"2022/09/28","166394","56473","541777","98898","863542"
"2022/09/27","177850","101","155375","65140","398466"
"2022/09/26","67527","126320","205105","198892","597844"
"2022/09/23","112259","58255","541720","19285","731519"
"2022/09/22","58352","21228","322179","695","402454"
"2022/09/21","91778","19659","162014","90807","364258"
"2022/09/20","125646","17901","117159","68271","328977"
"2022/09/19","149294","3179","292780","139729","584982"
"2022/09/16","37236","1","153156","5251145","5441538"
"2022/09/15","53892","5400","214212","1029191","1302695"
"2022/09/14","182892","0","297008","1157852","1637752"
"2022/09/13","247821","4141","304658","1257444","1814064"
"2022/09/08","365663","33738","723542","2053699","3176642"
"2022/09/07","127497","7027","236183","13480","384187"
"2022/09/06","47796","2507","95657","29454","175414"
"2022/09/05","56900","42602","240666","16730","356898"
"2022/09/02","52995","16215","282092","53640","404942"
"2022/09/01","243262","80604","224807","20370","569043"
"2022/08/31","40681","32531","137957","141560","352729"
"2022/08/30","41721","29209","238343","78548","387821"
"2022/08/29","104167","13081","173937","68676","359861"
"2022/08/26","36829","5407","122473","12671","177380"
"2022/08/25","127266","2000","147366","57742","334374"
"2022/08/24","60290","3039","268862","45124","377315"
"2022/08/23","72795","13542","389540","24018","499895"
"2022/08/22","56044","4366","201946","12649","275005"
"2022/08/19","31659","5000","121963","35105","193727"
"2022/08/18","63080","12530","107077","44026","226713"
"2022/08/17","49250","5300","161478","29846","245874"
"2022/08/16","80991","6224","230040","21590","338845"
"2022/08/12","43028","6144","162254","23727","235153"
"2022/08/11","72694","16774","118763","89653","297884"
"2022/08/10","45505","5501","116917","44538","212461"
"2022/08/09","55662","3359","226577","27975","313573"
"2022/08/08","156701","13421","433148","97809","701079"
"2022/08/05","190463","5014","288230","84820","568527"
"2022/08/04","235402","5502","288068","180788","709760"
"2022/08/03","525459","12372","1148576","245455","1931862"
"2022/08/02","157575","324","126163","79808","363870"
"2022/08/01","359824","25602","817292","170497","1373215"
"2022/07/29","172974","1045","280627","168192","622838"
"2022/07/28","62270","15504","145783","4531","228088"
"2022/07/27","85270","0","69746","14298","169314"
"2022/07/26","52265","0","87350","30538","170153"
"2022/07/25","29981","501","142106","55061","227649"
"2022/07/22","63561","10223","216061","132930","422775"
"2022/07/21","178724","1933","238785","109546","528988"
"2022/07/20","36139","56275","332233","214366","639013"
"2022/07/19","56579","19625","320604","604575","1001383"
"2022/07/18","133517","31439","372005","203495","740456"
"2022/07/15","175155","12729","345800","217018","750702"
"2022/07/14","250115","1500","458587","317758","1027960"
"2022/07/13","198457","91077","595387","77190","962111"
"2022/07/12","165045","78558","910707","180624","1334934"
"2022/07/11","146591","59859","647130","98728","952308"
"2022/07/08","800441","57700","965776","271820","2095737"
"2022/07/07","194242","20801","683619","119085","1017747"
"2022/07/06","207304","25201","559717","73644","865866"
"2022/07/05","397271","24961","359097","44097","825426"
"2022/07/04","355350","133787","842130","358531","1689798"
"2022/07/01","375250","18678","1042303","263455","1699686"
"2022/06/30","206466","38392","789083","169153","1203094"
"2022/06/29","467827","36660","1480798","54941","2040226"
"2022/06/28","637719","60249","769019","50614","1517601"
"2022/06/27","233024","22319","239617","68792","563752"
"2022/06/24","288675","27481","450872","54557","821585"
"2022/06/23","490333","33740","327653","139182","990908"
"2022/06/22","144396","60069","552525","202468","959458"
"2022/06/21","196031","15296","258176","43808","513311"
"2022/06/20","155246","72962","627673","370307","1226188"
"2022/06/17","347615","39561","445781","338626","1171583"
"2022/06/16","100202","5702","507254","50662","663820"
"2022/06/15","116585","19134","268326","52051","456096"
"2022/06/14","146695","29693","448359","47220","671967"
"2022/06/13","294533","37205","385149","26178","743065"
"2022/06/10","644789","1000","69899","35960","751648"
"2022/06/09","109363","1238","171029","46062","327692"
"2022/06/08","231649","9889","235134","39825","516497"
"2022/06/07","444169","305801","259745","152542","1162257"
"2022/06/03","308042","16701","195272","78522","598537"
"2022/06/02","256461","27463","173572","42190","499686"
"2022/05/31","193053","81500","236463","268476","779492"
"2022/05/30","266748","42720","169610","67910","546988"
"2022/05/27","301770","8010","134134","97073","540987"
"2022/05/26","316373","246423","118042","57026","737864"
"2022/05/25","180877","55493","115464","31958","383792"
"2022/05/24","194746","61220","137746","41476","435188"
"2022/05/23","202840","69579","343165","199382","814966"
"2022/05/20","155624","1","146436","65799","367860"
"2022/05/19","190325","30310","432647","103024","756306"
"2022/05/18","103234","1311","86730","17917","209192"
"2022/05/17","228419","16227","441690","137963","824299"
"2022/05/16","164737","1","90894","54766","310398"
"2022/05/13","117061","16089","96456","48695","278301"
"2022/05/12","133894","41300","275993","102861","554048"
"2022/05/11","201243","2","156749","27707","385701"
"2022/05/10","146583","12501","198683","21668","379435"
"2022/05/09","124415","5061","138411","86563","354450"
"2022/05/06","181172","5781","349375","105153","641481"
"2022/05/04","218946","26934","291544","35476","572900"
"2022/05/03","294326","5776","706934","100125","1107161"
"2022/05/02","169997","1000","122066","16284","309347"
"2022/04/29","304097","17500","204206","72655","598458"
"2022/04/28","335987","5000","320781","99711","761479"
"2022/04/27","259167","7171","258853","27925","553116"
"2022/04/26","273679","1000","254619","208827","738125"
"2022/04/25","305948","1000","315836","196654","819438"
"2022/04/22","178233","16551","303247","122792","620823"
"2022/04/21","191342","7582","363040","70654","632618"
"2022/04/20","323044","20448","255588","95795","694875"
"2022/04/19","168726","341","285580","1421043","1875690"
"2022/04/18","633902","30407","1114642","127629","1906580"
"2022/04/15","475677","22919","513161","178490","1190247"
"2022/04/14","445566","0","385449","483862","1314877"
"2022/04/13","378514","1730","340810","206206","927260"
"2022/04/12","389623","20000","405447","325478","1140548"
"2022/04/11","235182","47702","341151","292822","916857"
"2022/04/08","275992","3474","476956","351895","1108317"
"2022/04/07","365248","6903","224061","121456","717668"
"2022/04/06","228000","0","258203","184452","670655"
"2022/04/05","134673","4236","251234","219594","609737"
"2022/04/04","73004","42362","327909","215529","658804"
"2022/04/01","92612","21526","355287","134357","603782"
"2022/03/31","219914","29379","391756","230005","871054"
"2022/03/30","71232","57054","250600","164274","543160"
"2022/03/29","57687","10156","165616","131305","364764"
"2022/03/28","96279","8827","260776","175659","541541"
"2022/03/25","133942","10042","296862","179927","620773"
"2022/03/24","242354","7633","161741","188701","600429"
"2022/03/23","76069","44941","242060","236568","599638"
"2022/03/22","133818","14000","222055","262130","632003"
"2022/03/21","203902","16101","194048","48238","462289"
"2022/03/18","160150","924","286184","55637","502895"
"2022/03/17","157871","8024","214570","147948","528413"
"2022/03/16","175321","36691","167428","125986","505426"
"2022/03/15","140380","31151","156659","96991","425181"
"2022/03/14","144504","26730","149986","75560","396780"
"2022/03/11","133487","18737","201180","148527","501931"
"2022/03/10","184162","48896","145581","87054","465693"
"2022/03/08","175216","24924","240063","98106","538309"
"2022/03/07","93842","17161","172768","211807","495578"
"2022/03/04","155438","17348","204521","272412","649719"
"2022/03/03","182674","11735","236062","118664","549135"
"2022/03/02","143480","71001","108098","112291","434870"
"2022/02/28","92148","28087","225181","82211","427627"
"2022/02/25","213016","19347","127241","206034","565638"
"2022/02/24","139028","11400","296084","212854","659366"
"2022/02/23","94213","5001","71635","167883","338732"
"2022/02/22","81595","9000","208914","164044","463553"
"2022/02/21","78822","10009","92889","191607","373327"
"2022/02/18","62441","39314","138205","186523","426483"
"2022/02/17","72289","10000","290876","332516","705681"
"2022/02/16","205603","10000","98159","121559","435321"
"2022/02/15","129134","13003","121705","37806","301648"
"2022/02/14","120058","5","115583","26986","262632"
"2022/02/11","65623","35507","153812","107402","362344"
"2022/02/10","63774","9026","140921","93257","306978"
"2022/02/09","48678","2413","183417","101379","335887"
"2022/02/08","115471","7596","173677","130177","426921"
"2022/02/07","47439","10001","194366","116878","368684"
"2022/02/04","104868","1733","133121","114009","353731"
"2022/02/03","125711","4953","187127","138459","456250"
"2022/01/28","241063","41627","436909","102055","821654"
"2022/01/27","217312","39663","655081","64257","976313"
"2022/01/26","115345","70166","145748","59991","391250"
"2022/01/25","144716","45495","506322","41555","738088"
"2022/01/24","233265","35480","199520","32832","501097"
"2022/01/21","87259","58579","200893","78374","425105"
"2022/01/20","92964","25307","183839","64542","366652"
"2022/01/19","101963","63078","401103","41576","607720"
"2022/01/18","201648","40905","253349","27142","523044"
"2022/01/17","235423","159576","315186","44336","754521"
"2022/01/14","146867","59832","207921","64404","479024"
"2022/01/13","104389","96940","144784","24053","370166"
"2022/01/12","94658","20659","97624","21489","234430"
"2022/01/11","273664","159977","251514","31798","716953"
"2022/01/10","214366","12920","106930","37675","371891"
"2022/01/07","103139","19003","101554","30404","254100"
"2022/01/06","117935","134027","194617","46164","492743"
"2022/01/05","177312","29948","343549","26952","577761"
"2022/01/04","169944","157173","386367","29375","742859"
"2022/01/03","269615","44861","222220","55453","592149"
"2021/12/30","297412","63506","374764","47711","783393"
"2021/12/29","89213","86602","1045030","97904","1318749"
"2021/12/28","527347","51784","513950","182735","1275816"
"2021/12/27","2137601","19246","442285","179750","2778882"
"2021/12/24","107829","107352","283195","165676","664052"
"2021/12/23","185261","10066","376479","98477","670283"
"2021/12/22","92403","19515","318081","27458","457457"
"2021/12/21","123503","5010","410894","1943","541350"
"2021/12/20","118778","6301","403466","80780","609325"
"2021/12/17","169304","5001","342059","37360","553724"
"2021/12/16","67761","2000","223220","4413","297394"
"2021/12/15","174665","1002","397104","65008","637779"
"2021/12/14","88412","2003","302413","41375","434203"
"2021/12/13","144097","0","146596","44461","335154"
"2021/12/10","185190","21293","210586","38356","455425"
"2021/12/09","290824","4634","385977","50898","732333"
"2021/12/08","178328","78790","390376","91500","738994"
"2021/12/07","87109","164449","275233","36940","563731"
"2021/12/06","51535","28509","216855","29493","326392"
"2021/12/03","154832","34253","263076","57067","509228"
"2021/12/02","333850","38228","222317","83217","677612"
"2021/12/01","132951","34722","296946","121733","586352"
"2021/11/30","239629","86029","661732","148730","1136120"
"2021/11/29","143364","94570","324363","15823","578120"
"2021/11/26","261374","82491","239934","111108","694907"
"2021/11/25","49006","69890","390320","25577","534793"
"2021/11/24","217093","6375","230084","26176","479728"
"2021/11/23","52861","20389","280710","13596","367556"
"2021/11/22","127456","18186","347558","14338","507538"
"2021/11/19","229294","100084","171924","35087","536389"
"2021/11/18","100797","35168","516613","65843","718421"
"2021/11/17","119168","25550","574252","5227","724197"
"2021/11/16","117918","62275","345299","16341","541833"
"2021/11/15","121143","27458","208647","38187","395435"
"2021/11/12","173146","74","177520","17010","367750"
"2021/11/11","327971","3000","174407","75571","580949"
"2021/11/10","327734","1301","250962","110232","690229"
"2021/11/09","170448","110001","306779","72633","659861"
"2021/11/08","81922","17612","203025","560286","862845"
"2021/11/05","278520","50365","307771","68479","705135"
"2021/11/04","240003","9381","265783","23031","538198"
"2021/11/03","169339","784","246709","121228","538060"
"2021/11/02","90422","9321","251512","71735","422990"
"2021/11/01","229284","12450","401955","32435","676124"
"2021/10/29","206292","46525","306803","24026","583646"
"2021/10/28","492503","27642","409842","171333","1101320"
"2021/10/27","263401","22672","220346","98854","605273"
"2021/10/26","281495","3025","292255","62211","638986"
"2021/10/25","298636","64523","285556","55479","704194"
"2021/10/22","326709","85065","237986","20344","670104"
"2021/10/21","203219","183144","168960","81496","636819"
"2021/10/20","235683","1184","259068","69242","565177"
"2021/10/19","326348","78335","314842","100850","820375"
"2021/10/18","42670","5000","243390","38294","329354"
"2021/10/15","230391","19420","260255","83565","593631"
"2021/10/14","127571","0","162550","56818","346939"
"2021/10/13","184850","9742","290724","41826","527142"
"2021/10/12","156018","22086","462301","206140","846545"
"2021/10/08","176249","50135","183582","20217","430183"
"2021/10/07","61597","28483","154967","213598","458645"
"2021/10/06","299728","24686","580327","396929","1301670"
"2021/10/05","137651","20904","432052","164613","755220"
"2021/10/01","242429","21871","394818","60160","719278"
"2021/09/30","328067","31043","349824","70407","779341"
"2021/09/29","407564","32546","281416","90633","812159"
"2021/09/28","330201","33334","568880","97133","1029548"
"2021/09/27","1165445","60119","615079","137998","1978641"
"2021/09/24","1492437","17847","354867","65907","1931058"
"2021/09/23","719398","7629","483367","154795","1365189"
"2021/09/17","4290486","34004","380505","299270","5004265"
"2021/09/16","337934","21474","684326","991509","2035243"
"2021/09/15","212430","48650","438069","138011","837160"
"2021/09/14","310113","2310","323718","143511","779652"
"2021/09/13","200609","15041","533317","115155","864122"
"2021/09/10","193144","6947","256465","31220","487776"
"2021/09/09","374831","840","200475","49286","625432"
"2021/09/08","233694","92300","113622","5674","445290"
"2021/09/07","227838","92889","120605","10660","451992"
"2021/09/06","193775","54000","240143","212","488130"
"2021/09/03","410853","70000","148319","47220","676392"
"2021/09/02","438517","105669","490401","14091","1048678"
"2021/09/01","148569","75324","465501","82742","772136"
"2021/08/31","345266","30270","625177","199751","1200464"
"2021/08/30","61757","0","237826","85879","385462"
"2021/08/27","143774","23083","233421","133621","533899"
"2021/08/26","240916","100","79281","25496","345793"
"2021/08/25","114430","100869","174464","88414","478177"
"2021/08/24","105565","90871","157592","90155","444183"
"2021/08/23","224457","41760","467330","83693","817240"
"2021/08/20","172873","3863","243553","175189","595478"
"2021/08/19","123042","20190","239751","117291","500274"
"2021/08/18","152942","0","95491","125644","374077"
"2021/08/17","223828","691","191291","64381","480191"
"2021/08/13","152363","11691","361370","99642","625066"
"2021/08/12","82744","20000","141615","143074","387433"
"2021/08/11","166767","10002","129724","97103","403596"
"2021/08/10","90045","0","74482","114083","278610"
"2021/08/09","200695","53439","324190","1047223","1625547"
"2021/08/06","278758","24861","212042","67291","582952"
"2021/08/05","93890","48848","367349","330355","840442"
"2021/08/04","298263","6379","165977","61254","531873"
"2021/08/03","400595","15676","258452","129486","804209"
"2021/08/02","212752","16768","138104","11699","379323"
"2021/07/30","202316","59483","133805","31625","427229"
"2021/07/29","64084","40340","158644","48374","311442"
"2021/07/28","175672","93654","561067","64794","895187"
"2021/07/27","97471","5000","168655","10617","281743"
"2021/07/26","185970","5000","447482","128854","767306"
"2021/07/23","125392","20553","301874","29637","477456"
"2021/07/22","137744","59360","267327","42075","506506"
"2021/07/21","103688","41000","149807","1047341","1341836"
"2021/07/20","100452","1838","262801","56800","421891"
"2021/07/19","100292","1139","158345","72112","331888"
"2021/07/16","62712","50","226995","78996","368753"
"2021/07/15","184305","29970","186439","30319","431033"
"2021/07/14","253140","22236","257168","32652","565196"
"2021/07/13","114224","7327","165220","30303","317074"
"2021/07/12","119274","14541","232692","52206","418713"
"2021/07/09","73782","5844","161512","135545","376683"
"2021/07/08","104007","28876","206886","87682","427451"
"2021/07/07","66368","15000","160624","88028","330020"
"2021/07/06","67703","14502","364510","146149","592864"
"2021/07/05","87945","73490","737681","627949","1527065"
"2021/07/02","73841","21248","461104","374080","930273"
"2021/07/01","304575","2093","374228","93402","774298"
"2021/06/30","118378","51532","435891","61025","666826"
"2021/06/29","291345","54314","1407300","91242","1844201"
"2021/06/28","565440","60586","938877","622673","2187576"
"2021/06/25","363954","91709","390217","42479","888359"
"2021/06/24","214351","14384","274894","29412","533041"
"2021/06/23","330198","44623","588568","6709","970098"
"2021/06/22","161772","101773","426399","6144","696088"
"2021/06/21","243594","30500","498759","29532","802385"
"2021/06/18","2165808","45600","488171","208152","2907731"
"2021/06/17","280139","24703","479102","164220","948164"
"2021/06/16","1453031","72623","882187","32929","2440770"
"2021/06/15","325982","69757","598097","7671","1001507"
"2021/06/14","1901771","65583","223718","11923","2202995"
"2021/06/11","291144","68818","313025","42460","715447"
"2021/06/10","4063942","10630","84216","3698","4162486"
"2021/06/09","569769","209058","434518","23705","1237050"
"2021/06/08","75057","119775","292383","10509","497724"
"2021/06/07","268278","54810","308865","247","632200"
"2021/06/04","109758","23000","314338","5363","452459"
"2021/06/03","351129","217000","1099251","27638","1695018"
"2021/06/02","5832028","154868","524296","259659","6770851"
"2021/06/01","1604561","24994","355335","158012","2142902"
"2021/05/31","231936","15025","387173","111930","746064"
"2021/05/28","200165","10000","222394","11316","443875"
"2021/05/27","537646","10951","141883","60193","750673"
"2021/05/26","115591","21208","82363","387","219549"
"2021/05/25","309554","12872","95412","72062","489900"
"2021/05/24","384807","0","160433","4833","550073"
"2021/05/21","155499","3000","122218","11728","292445"
"2021/05/20","211454","30360","130168","10611","382593"
"2021/05/18","133450","15778","236767","12893","398888"
"2021/05/17","74837","20532","139780","8508","243657"
"2021/05/14","172754","51413","176163","9881","410211"
"2021/05/13","181905","111467","325150","4249","622771"
"2021/05/12","215800","10684","125085","26197","377766"
"2021/05/11","91551","46148","168466","24661","330826"
"2021/05/10","139053","177554","304466","20997","642070"
"2021/05/07","100471","150097","601722","12649","864939"
"2021/05/06","71585","139342","359104","45899","615930"
"2021/05/04","127248","57052","436276","52719","673295"
"2021/05/03","92057","25260","506459","15660","639436"
"2021/04/30","223340","51354","388664","30427","693785"
"2021/04/29","9595317","22600","228628","766969","10613514"
"2021/04/28","253119","93212","724161","9947","1080439"
"2021/04/27","73646","30469","237271","193380","534766"
"2021/04/26","138632","15098","498099","700","652529"
"2021/04/23","70362","5047","266455","28854","370718"
"2021/04/22","134427","6745","317967","6036","465175"
"2021/04/21","37950","21900","148493","947","209290"
"2021/04/20","77154","57000","291059","17310","442523"
"2021/04/19","77653","6913","417254","64162","565982"
"2021/04/16","82584","25165","480716","100096","688561"
"2021/04/15","5247227","129967","147159","78213","5602566"
"2021/04/14","88118","32000","189914","8656","318688"
"2021/04/13","7261670","7731","123285","1685","7394371"
"2021/04/12","116982","6101","214597","12685","350365"
"2021/04/09","158605","30771","132062","5012111","5333549"
"2021/04/08","53174","5836","259135","23557","341702"
"2021/04/07","71154","6054","77114","11850","166172"
"2021/04/06","15738","22115","127068","12845","177766"
"2021/04/05","51103","65179","215820","28995","361097"
"2021/04/02","42489","11485","135666","91116","280756"
"2021/04/01","49394","21800","99135","47103","217432"
"2021/03/31","97351","13758","206626","27090","344825"
"2021/03/30","1064897","12067","76115","24889","1177968"
"2021/03/29","4911492","14450","221031","49317","5196290"
"2021/03/26","4373645","16390","128007","88556","4606598"
"2021/03/25","42639","19521","80016","29384","171560"
"2021/03/24","64636","3000","71159","36462","175257"
"2021/03/23","96045","18000","99798","102560","316403"
"2021/03/22","17949","10900","93353","14038","136240"
"2021/03/19","84112","42068","168647","5955","300782"
"2021/03/18","23327","31691","71612","10007","136637"
"2021/03/17","21721","4000","42367","13868","81956"
"2021/03/16","43871","300","30259","26392","100822"
"2021/03/15","55564","41209","81039","27216","205028"
"2021/03/12","57661","385","114144","10079","182269"
"2021/03/11","51603","0","87035","9305","147943"
"2021/03/10","75914","0","101687","3754","181355"
"2021/03/09","23825","0","75978","24315","124118"
"2021/03/08","33666","1156","75089","2861","112772"
"2021/03/05","18255","1924","92090","4328","116597"
"2021/03/04","15622","0","41133","1804","58559"
"2021/03/03","22297","0","72015","45931","140243"
"2021/03/02","21321","0","101434","31185","153940"
"2021/02/26","105063","9038","61960","24124","200185"
"2021/02/25","74646","3400","75867","55666","209579"
"2021/02/24","95926","0","84525","74998","255449"
"2021/02/23","142244","200","36071","2703","181218"
"2021/02/22","73876","20098","184632","5879","284485"
"2021/02/19","41215","10000","185128","21787","258130"
"2021/02/18","43456","0","69280","7632","120368"
"2021/02/17","27116","15254","110667","21364","174401"
"2021/02/16","62010","0","57561","6162","125733"
"2021/02/15","57806","96","49184","21581","128667"
"2021/02/10","27687","0","66601","12455","106743"
"2021/02/09","79645","0","50877","0","130522"
"2021/02/08","181534","3000","95335","50995","330864"
"2021/02/05","87178","300","68684","7383","163545"
"2021/02/04","79921","2898","86387","7341","176547"
"2021/02/03","56004","3000","38057","56241","153302"
"2021/02/02","29604","200","59537","10939","100280"
"2021/02/01","53269",,"23875","2310","79454"
"2021/01/29","63170","3098","69807","5818","141893"
"2021/01/28","59900","196","54904","5461","120461"
"2021/01/27","64196","600","29118","16212","110126"
"2021/01/26","97417","5000","92687","5289","200393"
"2021/01/25","12949","100","54675","18113","85837"
"2021/01/22","52493","9250","106538","6219","174500"
"2021/01/21","30972","38432","41259","9775","120438"
"2021/01/20","125925","30000","40499","16425","212849"
"2021/01/19","157279","0","78329","3022","238630"
"2021/01/18","273224","14939","40090","41892","370145"
"2021/01/15","74094","1699","93322","82968","252083"
"2021/01/14","24325","201","49869","44822","119217"
"2021/01/13","69728","2500","60579","57314","190121"
"2021/01/12","93754","7448","94821","46898","242921"
"2021/01/11","116131","8135","398322","83442","606030"
"2021/01/08","104539","8880","382043","10547","506009"
"2021/01/07","116184","12546","317728","3780","450238"
"2021/01/06","99827","16841","120974","100","237742"
"2021/01/05","86200","1000","110207","164308","361715"
"2021/01/04","42409","7190","122414","258895","430908"
"2020/12/30","81875","500","214952","32781","330108"
"2020/12/29","65116","2000","376039","166459","609614"
"2020/12/28","553208","18695","335948","35202","943053"
"2020/12/24","41610","500","196283","24839","263232"
"2020/12/23","1033539","12491","122094","57019","1225143"
"2020/12/22","88534","11500","126259","65774","292067"
"2020/12/21","30708","11112","142472","118285","302577"
"2020/12/18","16879","6122","231713","3033767","3288481"
"2020/12/17","22276","0","330870","410091","763237"
"2020/12/16","170434","0","238172","299931","708537"
"2020/12/15","131616","6034","152264","418045","707959"
"2020/12/14","12726","1709","135833","184237","334505"
"2020/12/11","80491","2000","240694","136924","460109"
"2020/12/10","65732","600","104129","124364","294825"
"2020/12/09","23915","0","123998","95753","243666"
"2020/12/08","61365","900","86219","54693","203177"
"2020/12/07","115015","809","115904","129887","361615"
"2020/12/04","93808","0","354368","24368","472544"
"2020/12/03","31334",,"103787","16682","151803"
"2020/12/02","17619","0","113168","8530","139317"
"2020/12/01","124898","2953","284990","14220","427061"
"2020/11/30","92209","6430","217010","236323","551972"
"2020/11/27","74875","1612","51235","122981","250703"
"2020/11/26","43487","1602","55334","117972","218395"
"2020/11/25","80465","15200","204394","114081","414140"
"2020/11/24","57297","20078","110759","107772","295906"
"2020/11/23","92870","163","108794","237961","439788"
"2020/11/20","25412","1000","45796","32521","104729"
"2020/11/19","131607","1216","51261","64401","248485"
"2020/11/18","82631","6000","46453","76345","211429"
"2020/11/17","72047","0","296275","24888","393210"
"2020/11/16","89769","2000","263111","65011","419891"
"2020/11/13","110136","8500","263346","54622","436604"
"2020/11/12","48069","500","172359","23841","244769"
"2020/11/11","21493",,"46558","158639","226690"
"2020/11/10","77191","6988","138086","21201","243466"
"2020/11/09","58249","0","331618","10871","400738"
"2020/11/06","54748",,"129746","31192","215686"
"2020/11/05","66071","0","105155","24801","196027"
"2020/11/04","18536","13000","75203","16766","123505"
"2020/11/03","26119","0","136193","12929","175241"
"2020/11/02","69630","0","150218","22458","242306"
"2020/10/30","100115","0","167035","28198","295348"
"2020/10/29","19864","191","83423","4110","107588"
"2020/10/28","15249","0","87479","16196","118924"
"2020/10/27","43961","10100","177081","92540","323682"
"2020/10/26","64577","28150","152019","25540","270286"
"2020/10/23","27859","42000","91139","33098","194096"
"2020/10/22","58483","178844","60506","63742","361575"
"2020/10/21","54682","10439","73474","17684","156279"
"2020/10/20","38500","1233","73806","5893","119432"
"2020/10/19","20614","1636","121590","17767","161607"
"2020/10/16","67182","0","267264","40016","374462"
"2020/10/15","40950",,"117852","9310","168112"
"2020/10/14","24722","87","177023","59","201891"
"2020/10/13","30028","22","247914","76823","354787"
"2020/10/12","35601","0","170520","44649","250770"
"2020/10/08","29000","2206","274440","32170","337816"
"2020/10/07","33462","500","97378","7660","139000"
"2020/10/06","82459","6000","183094","44836","316389"
"2020/10/05","68339","200","116719","3414","188672"
"2020/09/29","58866","0","44548","10709","114123"
"2020/09/28","21909","0","36201","525","58635"
"2020/09/25","54914","0","105528","473","160915"
"2020/09/24","32158","0","38148","25907","96213"
"2020/09/23","229198","1000","150660","66349","447207"
"2020/09/22","115823","0","45039","6835","167697"
"2020/09/21","19058","40","166197","6779","192074"
"2020/09/18","49040","3000","69319","1","121360"
"2020/09/17","59620","3687","200123","1981","265411"
"2020/09/16","51473","2000","104331","19635","177439"
"2020/09/15","18662","2500","86329","1280","108771"
"2020/09/14","186031","5264","141775","13436","346506"
"2020/09/11","18460","1000","181956","9731","211147"
"2020/09/10","97795","105","76483","1","174384"
"2020/09/09","51545","0","108930","7865","168340"
"2020/09/08","42068","1935","438966","10001","492970"
"2020/09/07","17697","1629","276659","9325","305310"
"2020/09/04","38310","204","118498","16526","173538"
"2020/09/03","106149","32441","101644","0","240234"
"2020/09/02","32368","7045","155809","0","195222"
"2020/09/01","31847","0","60110","0","91957"
"2020/08/31","26371","18811","141165","9046","195393"
"2020/08/28","31036","36115","237031","1762","305944"
"2020/08/27","19164","3512","172145","9367","204188"
"2020/08/26","33912","60531","192093","4630","291166"
"2020/08/25","57471","61500","189700","257","308928"
"2020/08/24","51820","76584","320849","1293","450546"
"2020/08/21","104032","30421","200078","9051","343582"
"2020/08/20","121493","99570","439647","8766","669476"
"2020/08/19","186550","55781","251561","20207","514099"
"2020/08/18","216585","68500","289712","11687","586484"
"2020/08/14","129418","48008","288444","17964","483834"
"2020/08/13","675316","52230","302271","200","1030017"
"2020/08/12","181358","126398","652408","28046","988210"
"2020/08/11","117148","25506","630119","36654","809427"
"2020/08/10","227584","32070","791903","5009","1056566"
"2020/08/07","691175","269792","3760005","61425","4782397"