일자,기관 합계,기타법인,개인,외국인 합계,전체
"2023/05/04","60113","292","31518","8947","100870"
"2023/05/03","30625","3149","14764","3451","51989"
"2023/05/02","46652","2360","21947","11304","82263"
"2023/04/28","51724","637","12449","5077","69887"
"2023/04/27","32629","296","32837","7683","73445"
"2023/04/26","22119","1654","31927","40115","95815"
"2023/04/25","61124","331","19745","26868","108068"
"2023/04/24","48269","2214","67588","5748","123819"
"2023/04/21","44072","937","17742","8114","70865"
"2023/04/20","49411","339","25932","25512","101194"
"2023/04/19","37285","819","26436","7430","71970"
"2023/04/18","49617","595","28865","4915","83992"
"2023/04/17","43007","594","28414","6533","78548"
"2023/04/14","39957","5754","56743","34880","137334"
"2023/04/13","45117","10879","12099","16975","85070"
"2023/04/12","35766","432","27648","10695","74541"
"2023/04/11","33310","379","25649","145","59483"
"2023/04/10","16164","328","22865","3","39360"
"2023/04/07","38648","299","28225","36","67208"
"2023/04/06","17530","313","11820","2791","32454"
"2023/04/05","37500","299","11228","27","49054"
"2023/04/04","20089","601","23482","21590","65762"
"2023/04/03","14552","381","14296","740","29969"
"2023/03/31","21532","90","11671","1705","34998"
"2023/03/30","9092","60","29922","1030","40104"
"2023/03/29","15132","59","64060","17177","96428"
"2023/03/28","18203","382","12696","2142","33423"
"2023/03/27","52033","335","22336","5425","80129"
"2023/03/24","7601","323","7093","3586","18603"
"2023/03/23","18557","299","29888","5345","54089"
"2023/03/22","19144","335","17873","812","38164"
"2023/03/21","18135","314","10416","149","29014"
"2023/03/20","13661","3144","11020","3276","31101"
"2023/03/17","17358","3306","7350","832","28846"
"2023/03/16","19780","317","15509","11290","46896"
"2023/03/15","24739","299","10513","12562","48113"
"2023/03/14","24596","699","36488","2423","64206"
"2023/03/13","24333","338","26824","5198","56693"
"2023/03/10","22162","337","8865","3002","34366"
"2023/03/09","13560","919","22088","4186","40753"
"2023/03/08","10704","336","8538","2","19580"
"2023/03/07","13212","357","20163","1807","35539"
"2023/03/06","9746","491","12061","293","22591"
"2023/03/03","9518","275","13207","1137","24137"
"2023/03/02","7204","546","28546","15520","51816"
"2023/02/28","13301","370","11230","3250","28151"
"2023/02/27","12341","627","10913","1786","25667"
"2023/02/24","24490","367","13510","1210","39577"
"2023/02/23","29357","399","9899","1247","40902"
"2023/02/22","22809","296","7663","134","30902"
"2023/02/21","22509","301","15462","3204","41476"
"2023/02/20","31838","1987","28948","7284","70057"
"2023/02/17","13795","1858","15925","906","32484"
"2023/02/16","17701","5201","31577","8279","62758"
"2023/02/15","14059","2837","5338","359","22593"
"2023/02/14","12298","16","26342","3571","42227"
"2023/02/13","18381","477","11208","5104","35170"
"2023/02/10","14746","21","28513","2767","46047"
"2023/02/09","17197","0","51833","106","69136"
"2023/02/08","22028","0","20606","4177","46811"
"2023/02/07","17976","6","10039","2059","30080"
"2023/02/06","22395","1011","11137","289","34832"
"2023/02/03","4173","192","6566","0","10931"
"2023/02/02","27646","10","18118","7812","53586"
"2023/02/01","14654",,"28865","313","43832"
"2023/01/31","17456","4","25117","491","43068"
"2023/01/30","26592","18","13077","207","39894"
"2023/01/27","20515","124","22677","10369","53685"
"2023/01/26","36876","0","14402","8218","59496"
"2023/01/25","14934","0","21650","950","37534"
"2023/01/20","47270","67","67993","14515","129845"
"2023/01/19","22331","500","6073","552","29456"
"2023/01/18","49112","501","20796","3387","73796"
"2023/01/17","56660","502","8222","34772","100156"
"2023/01/16","35593","501","22462","6223","64779"
"2023/01/13","29806","502","4611","728","35647"
"2023/01/12","30488","501","26519","8018","65526"
"2023/01/11","11032","501","12878","733","25144"
"2023/01/10","14421","500","10435","618","25974"
"2023/01/09","29184","5147","18843","32","53206"
"2023/01/06","46863","501","6548","3574","57486"
"2023/01/05","28629","504","9394","8854","47381"
"2023/01/04","25134","2749","12440","2939","43262"
"2023/01/03","59113","502","8406","2897","70918"
"2023/01/02","37508","502","9022","5873","52905"
"2022/12/29","50794","501","17324","1053","69672"
"2022/12/28","37588","745","10943","570","49846"
"2022/12/27","39769","500","11037","8593","59899"
"2022/12/26","97645","501","21436","8315","127897"
"2022/12/23","166012","568","16893","13911","197384"
"2022/12/22","62890","501","11661","1670","76722"
"2022/12/21","133030","503","4185","22950","160668"
"2022/12/20","125858","500","17529","3226","147113"
"2022/12/19","80434","22","20950","18918","120324"
"2022/12/16","138592","1","27137","28934","194664"
"2022/12/15","57532","1000","13992","9170","81694"
"2022/12/14","68141","0","16126","12128","96395"
"2022/12/13","42814","711","21179","6433","71137"
"2022/12/12","30534","416","15566","7359","53875"
"2022/12/09","39338","1000","14090","1396","55824"
"2022/12/08","29688","101","8064","128","37981"
"2022/12/07","40264","0","11903","232","52399"
"2022/12/06","17884","2","24829","325","43040"
"2022/12/05","45506","2000","14236","2662","64404"
"2022/12/02","40311",,"26969","4657","71937"
"2022/12/01","37554","0","41663","5611","84828"
"2022/11/30","42465","5100","50087","12781","110433"
"2022/11/29","20293",,"22662","8074","51029"
"2022/11/28","38960","369","24942","1367","65638"
"2022/11/25","34122","0","29062","9934","73118"
"2022/11/24","36340","0","14564","6072","56976"
"2022/11/23","16094","1","15985","1511","33591"
"2022/11/22","25264","190","13775","28","39257"
"2022/11/21","37805",,"16103","8","53916"
"2022/11/18","27681",,"15997","1373","45051"
"2022/11/17","29790",,"21607","3886","55283"
"2022/11/16","80493","4095","17072","19655","121315"
"2022/11/15","28383",,"27852","2071","58306"
"2022/11/14","14855",,"58238","6559","79652"
"2022/11/11","56935",,"50437","14703","122075"
"2022/11/10","26837","200","19498","1041","47576"
"2022/11/09","26872",,"27344","3654","57870"
"2022/11/08","16076","5384","24761","10155","56376"
"2022/11/07","23978","12219","41818","6608","84623"
"2022/11/04","24680","303","14407","313","39703"
"2022/11/03","21638","4368","16538","916","43460"
"2022/11/02","53465","10280","18201","32342","114288"
"2022/11/01","29797","3200","45859","61130","139986"
"2022/10/31","34261","2401","57390","201","94253"
"2022/10/28","46950","1000","45571","15273","108794"
"2022/10/27","86736","4000","35566","38264","164566"
"2022/10/26","33420","1600","22209","1251","58480"
"2022/10/25","39348","0","24791","8398","72537"
"2022/10/24","70941","1219","49462","12855","134477"
"2022/10/21","122918","400","95105","41518","259941"
"2022/10/20","68957","1000","55977","20544","146478"
"2022/10/19","81562","18028","59815","15656","175061"
"2022/10/18","90809","5000","70381","37556","203746"
"2022/10/17","74509","36001","107306","11887","229703"
"2022/10/14","71311","22988","56855","11855","163009"
"2022/10/13","44077","56219","59979","4116","164391"
"2022/10/12","27514","15900","23665","5515","72594"
"2022/10/11","15325","3000","23407","3859","45591"
"2022/10/07","41053","2500","46772","40805","131130"
"2022/10/06","26671","26501","47214","2254","102640"
"2022/10/05","15704","3500","31473","5550","56227"
"2022/10/04","30279","45000","52192","3991","131462"
"2022/09/30","45814","0","66332","10190","122336"
"2022/09/29","26607","12900","59442","23282","122231"
"2022/09/28","11252","14001","76954","5503","107710"
"2022/09/27","28341","0","38392","4882","71615"
"2022/09/26","47101","14306","39766","4696","105869"
"2022/09/23","23914","9550","23924","1244","58632"
"2022/09/22","26033","10032","13884","975","50924"
"2022/09/21","28913","14000","10338","11372","64623"
"2022/09/20","22336","10125","15966","16212","64639"
"2022/09/19","15547","16702","90809","7898","130956"
"2022/09/16","17727","4580","67636","8565","98508"
"2022/09/15","31263","493","32113","7735","71604"
"2022/09/14","41699","2","12598","9716","64015"
"2022/09/13","81234","0","37925","19718","138877"
"2022/09/08","26128","1","72801","10701","109631"
"2022/09/07","42230","4694","57653","6352","110929"
"2022/09/06","18777","1000","32519","21378","73674"
"2022/09/05","7724","6315","49658","5134","68831"
"2022/09/02","24102","2185","46966","9512","82765"
"2022/09/01","16543","4001","58900","5530","84974"
"2022/08/31","15680","1000","44844","1489","63013"
"2022/08/30","43368","0","169743","9300","222411"
"2022/08/29","151451","4788","92310","6564","255113"
"2022/08/26","38297","2123","28360","128","68908"
"2022/08/25","40379","0","33473","5081","78933"
"2022/08/24","28844","623","71143","2801","103411"
"2022/08/23","48540","1874","40641","12712","103767"
"2022/08/22","29301","100","47829","8782","86012"
"2022/08/19","28211","1","27477","9157","64846"
"2022/08/18","46372","105","44866","17867","109210"
"2022/08/17","56116","0","10651","5044","71811"
"2022/08/16","86910","3000","24217","16799","130926"
"2022/08/12","41026",,"22809","18192","82027"
"2022/08/11","49350","180","38224","8732","96486"
"2022/08/10","32768","0","25383","11491","69642"
"2022/08/09","7694","0","17415","1254","26363"
"2022/08/08","17312","215","16473","1505","35505"
"2022/08/05","32045","19755","22300","5405","79505"
"2022/08/04","41822","73860","41802","32426","189910"
"2022/08/03","41225","484","40602","7409","89720"
"2022/08/02","40190","1709","36478","1395","79772"
"2022/08/01","69319","3965","47755","274","121313"
"2022/07/29","59683","273","52049","47673","159678"
"2022/07/28","22235","5568","42043","1245","71091"
"2022/07/27","22267","2000","21185","5882","51334"
"2022/07/26","29282","1092","25424","8515","64313"
"2022/07/25","57599","105888","106162","47915","317564"
"2022/07/22","25399","76930","61264","15914","179507"
"2022/07/21","26112","2266","45409","369","74156"
"2022/07/20","60101","12948","63674","7007","143730"
"2022/07/19","18465","230","42399","5042","66136"
"2022/07/18","92224","2693","16544","2287","113748"
"2022/07/15","82532","5170","105487","14114","207303"
"2022/07/14","25063","10186","57515","3936","96700"
"2022/07/13","18664","1000","139078","9909","168651"
"2022/07/12","23918","6005","26089","5088","61100"
"2022/07/11","34333","2060","45910","5351","87654"
"2022/07/08","137702","4005","6929","4938","153574"
"2022/07/07","38138","0","14033","3077","55248"
"2022/07/06","47471","63","14278","3943","65755"
"2022/07/05","61271","871","14785","16291","93218"
"2022/07/04","26326","13348","69737","15463","124874"
"2022/07/01","50745","3005","39069","20466","113285"
"2022/06/30","142247","1510","25603","18820","188180"
"2022/06/29","8746","20268","55084","36908","121006"
"2022/06/28","54039","22313","10316","17730","104398"
"2022/06/27","48407","19512","31719","17449","117087"
"2022/06/24","202505","20533","14961","40789","278788"
"2022/06/23","171348","44945","36435","104379","357107"
"2022/06/22","72023","9696","60111","16300","158130"
"2022/06/21","91239","6218","44141","2123","143721"
"2022/06/20","96293","1637","86401","87900","272231"
"2022/06/17","35241","5044","67444","5481","113210"
"2022/06/16","41002","2","59973","20619","121596"
"2022/06/15","45267","19073","67664","5879","137883"
"2022/06/14","64761","32576","77575","14771","189683"
"2022/06/13","34589","29311","36201","8149","108250"
"2022/06/10","62623","1937","63204","7416","135180"
"2022/06/09","20750","5014","19411","4059","49234"
"2022/06/08","38541","25758","25487","4148","93934"
"2022/06/07","66883","2990","11108","9565","90546"
"2022/06/03","74738","0","17127","10644","102509"
"2022/06/02","34022","19220","28499","8740","90481"
"2022/05/31","45603","6421","35407","31278","118709"
"2022/05/30","92521","4800","137428","2281","237030"
"2022/05/27","88051","235426","76468","36167","436112"
"2022/05/26","126162","171594","57021","15403","370180"
"2022/05/25","1074635","134672","32788","28437","1270532"
"2022/05/24","83651","94108","40101","18640","236500"
"2022/05/23","54527","40598","60246","14253","169624"
"2022/05/20","106116","7010","35904","16977","166007"
"2022/05/19","72456","12740","115437","9246","209879"
"2022/05/18","60238","14113","36699","2809","113859"
"2022/05/17","115572","17936","48999","2009","184516"
"2022/05/16","91180","12433","85487","16083","205183"
"2022/05/13","111175","8586","68337","11384","199482"
"2022/05/12","101538","9225","38947","11890","161600"
"2022/05/11","97330","0","104950","45300","247580"
"2022/05/10","532975","54832","185687","85872","859366"
"2022/05/09","4746623","103280","146258","43487","5039648"
"2022/05/06","60839","28000","70212","36495","195546"
"2022/05/04","144924","33003","155176","47374","380477"
"2022/05/03","87347","5544","62034","33007","187932"
"2022/05/02","30686","29000","37989","4766","102441"
"2022/04/29","73163","15367","19775","39034","147339"
"2022/04/28","78524","2600","50939","12654","144717"
"2022/04/27","121373","1617","29332","34632","186954"
"2022/04/26","110555","0","28751","49938","189244"
"2022/04/25","146812","0","66277","64730","277819"
"2022/04/22","81347","0","51035","60395","192777"
"2022/04/21","112704","0","38340","39660","190704"
"2022/04/20","65867","7987","22577","46244","142675"
"2022/04/19","105042","1001","29579","48252","183874"
"2022/04/18","98150","3538","61090","23486","186264"
"2022/04/15","141278","0","47940","83812","273030"
"2022/04/14","98856","1000","40111","35927","175894"
"2022/04/13","102749","0","36275","20095","159119"
"2022/04/12","74542","0","42295","47124","163961"
"2022/04/11","60253","0","52108","28034","140395"
"2022/04/08","99284","2220","54014","41785","197303"
"2022/04/07","98767","2778","274052","87311","462908"
"2022/04/06","197331","1000","20657","86314","305302"
"2022/04/05","136048","3190","19155","48882","207275"
"2022/04/04","39187","2827","33065","15151","90230"
"2022/04/01","74291","4233","89538","17317","185379"
"2022/03/31","47745","3980","28545","21193","101463"
"2022/03/30","30554","2871","54224","19448","107097"
"2022/03/29","36251","3190","29000","13839","82280"
"2022/03/28","50534","7441","40819","16202","114996"
"2022/03/25","21127","4013","12736","5688","43564"
"2022/03/24","41614","22062","44495","25339","133510"
"2022/03/23","32464","8988","7041","20469","68962"
"2022/03/22","75265","1020","29705","24126","130116"
"2022/03/21","13361","693","47680","19175","80909"
"2022/03/18","30104","9779","28422","55675","123980"
"2022/03/17","23329","20741","49464","9841","103375"
"2022/03/16","37751","7104","38999","10602","94456"
"2022/03/15","49149","1983","119896","37849","208877"
"2022/03/14","51011","2746","32538","13222","99517"
"2022/03/11","56392","10421","69228","55590","191631"
"2022/03/10","61725","2218","18242","22741","104926"
"2022/03/08","43856","1696","26783","5038","77373"
"2022/03/07","28209","1869","36877","9318","76273"
"2022/03/04","82797","2855","37999","88198","211849"
"2022/03/03","38963","0","15159","24052","78174"
"2022/03/02","137860","2593","78214","26640","245307"
"2022/02/28","26380",,"22519","18122","67021"
"2022/02/25","51888",,"16697","10969","79554"
"2022/02/24","42089","21306","26730","28927","119052"
"2022/02/23","36320","59908","5281","18115","119624"
"2022/02/22","34125","17317","4866","5417","61725"
"2022/02/21","35136","25001","8568","17100","85805"
"2022/02/18","57837","0","14163","23928","95928"
"2022/02/17","56319","9203","22047","24494","112063"
"2022/02/16","37551","3310","14207","5030","60098"
"2022/02/15","47480","10000","34336","19896","111712"
"2022/02/14","49562","2000","7858","8453","67873"
"2022/02/11","67258","2000","63296","34075","166629"
"2022/02/10","50765","10","30730","16360","97865"
"2022/02/09","55323","0","37699","40293","133315"
"2022/02/08","67748","3133","35896","9491","116268"
"2022/02/07","55700","5419","70911","20366","152396"
"2022/02/04","126322","5030","48532","95344","275228"
"2022/02/03","52814","20102","46068","63911","182895"
"2022/01/28","51038","2450","68318","50216","172022"
"2022/01/27","51292","2000","45640","20279","119211"
"2022/01/26","25697","52","18582","22239","66570"
"2022/01/25","39400","731","31247","26848","98226"
"2022/01/24","29866","2392","49778","12574","94610"
"2022/01/21","31463","0","39598","11395","82456"
"2022/01/20","19925","800","15980","11534","48239"
"2022/01/19","37327","6868","54519","14883","113597"
"2022/01/18","24425","4155","9991","2938","41509"
"2022/01/17","35007","31671","35571","9465","111714"
"2022/01/14","35243","0","11327","8028","54598"
"2022/01/13","24772","0","12639","10087","47498"
"2022/01/12","23760","2026","14242","3094","43122"
"2022/01/11","25266","5346","10576","4872","46060"
"2022/01/10","48292","168","10452","1374","60286"
"2022/01/07","46493","6088","21175","2305","76061"
"2022/01/06","41064","0","36475","14375","91914"
"2022/01/05","46211","1161","30935","8568","86875"
"2022/01/04","67457","223","16585","7585","91850"
"2022/01/03","78255","1844","25381","9847","115327"
"2021/12/30","18076","100","28960","377","47513"
"2021/12/29","10115","0","38447","3165","51727"
"2021/12/28","74638","4146","60563","11023","150370"
"2021/12/27","21861","0","53110","22590","97561"
"2021/12/24","39665","5300","58429","10786","114180"
"2021/12/23","30097","8245","35309","3378","77029"
"2021/12/22","23638","5649","9802","15625","54714"
"2021/12/21","11727","100","50811","11733","74371"
"2021/12/20","13334","5001","35974","2829","57138"
"2021/12/17","18516","0","44441","5545","68502"
"2021/12/16","13823",,"59672","9430","82925"
"2021/12/15","5506","0","49849","3135","58490"
"2021/12/14","7835","0","42238","13865","63938"
"2021/12/13","10925","3","66457","6175","83560"
"2021/12/10","11447","3040","81046","16442","111975"
"2021/12/09","20075","6001","51288","2972","80336"
"2021/12/08","27962","7","37450","1112","66531"
"2021/12/07","15817","1575","35564","6424","59380"
"2021/12/06","40875","160","55909","17781","114725"
"2021/12/03","60220","3003","27999","77396","168618"
"2021/12/02","55422","11403","103178","73654","243657"
"2021/12/01","93353","9512","64600","21486","188951"
"2021/11/30","120315","51091","225512","11479","408397"
"2021/11/29","191291","0","142329","30016","363636"
"2021/11/26","124852","19054","161309","39027","344242"
"2021/11/25","1485201","0","120557","7365","1613123"
"2021/11/24","19812","584","73122","29883","123401"
"2021/11/23","26523","5768","108436","41998","182725"
"2021/11/22","50090","188544","49790","33440","321864"
"2021/11/19","55329","877","46004","12910","115120"
"2021/11/18","27538","54141","39194","229","121102"
"2021/11/17","118743",,"30405","20914","170062"
"2021/11/16","53464","107450","57161","30135","248210"
"2021/11/15","52597","1","22853","6900","82351"
"2021/11/12","40955","12","25236","7673","73876"
"2021/11/11","32095","3498","20175","8490","64258"
"2021/11/10","42793","11538","41721","5215","101267"
"2021/11/09","30945","0","58018","8795","97758"
"2021/11/08","39516",,"39720","3138","82374"
"2021/11/05","67980","9581","34102","12130","123793"
"2021/11/04","40138","43209","103517","29859","216723"
"2021/11/03","41326","0","52581","18399","112306"
"2021/11/02","76885","0","83069","11616","171570"
"2021/11/01","76011","0","88933","29208","194152"
"2021/10/29","88584","0","100045","99517","288146"
"2021/10/28","86593","3579","147445","98237","335854"
"2021/10/27","49489","2260","36505","18720","106974"
"2021/10/26","22678","100","41207","10476","74461"
"2021/10/25","31538","8","13405","322","45273"
"2021/10/22","22661","8760","18197","1839","51457"
"2021/10/21","25586","17520","26228","12466","81800"
"2021/10/20","38782","0","58918","11876","109576"
"2021/10/19","64366","0","182041","91158","337565"
"2021/10/18","51923","1849","54347","17759","125878"
"2021/10/15","19464","0","34595","2273","56332"
"2021/10/14","41601","0","53070","8353","103024"
"2021/10/13","21043","18210","30566","6638","76457"
"2021/10/12","13640","0","44386","4318","62344"
"2021/10/08","29898","10000","56924","7931","104753"
"2021/10/07","32008","3","24449","4327","60787"
"2021/10/06","36433","4372","47169","16109","104083"
"2021/10/05","43292","21134","68059","6718","139203"
"2021/10/01","10426","2990","40361","3785","57562"
"2021/09/30","23367","6498","27988","4493","62346"
"2021/09/29","74416","42006","44523","7069","168014"
"2021/09/28","34434","39570","47044","2681","123729"
"2021/09/27","19484","27308","101245","11068","159105"
"2021/09/24","41162","0","20110","1423","62695"
"2021/09/23","9701","0","42830","9812","62343"
"2021/09/17","14131","0","52124","3914","70169"
"2021/09/16","20629","0","42468","7320","70417"
"2021/09/15","16256","3145","137404","10264","167069"
"2021/09/14","5337","0","53911","1462","60710"
"2021/09/13","8760","0","32113","2","40875"
"2021/09/10","5549","0","28228","3095","36872"
"2021/09/09","17505","1569","68452","12262","99788"
"2021/09/08","32146","1991","154480","16072","204689"
"2021/09/07","19799","2132","76485","13759","112175"
"2021/09/06","153460","10000","224891","64484","452835"
"2021/09/03","15945","2416","56485","13747","88593"
"2021/09/02","33915","0","57551","18793","110259"
"2021/09/01","31850","2004","75267","19871","128992"
"2021/08/31","25818","200","60572","7651","94241"
"2021/08/30","14151","920","72332","5860","93263"
"2021/08/27","82680","1023","78654","22606","184963"
"2021/08/26","38768","230","51249","807","91054"
"2021/08/25","49134","3000","45697","20336","118167"
"2021/08/24","29334","12570","56782","15481","114167"
"2021/08/23","58924","35795","44587","15432","154738"
"2021/08/20","84547","22112","70086","28116","204861"
"2021/08/19","101817","19534","103671","27608","252630"
"2021/08/18","53943","2000","49631","9328","114902"
"2021/08/17","34787","12370","64980","410","112547"
"2021/08/13","28858","2852","55167","6956","93833"
"2021/08/12","4284","500","25872","938","31594"
"2021/08/11","31946","0","21067","8043","61056"
"2021/08/10","47827","0","33655","8537","90019"
"2021/08/09","21816","0","33749","1252","56817"
"2021/08/06","70009","0","31417","9929","111355"
"2021/08/05","68716","5325","131185","35237","240463"
"2021/08/04","177223","821","71159","21041","270244"
"2021/08/03","24228","3148","38660","1325","67361"
"2021/08/02","54879","843","35547","632","91901"
"2021/07/30","39107","186","75408","5283","119984"
"2021/07/29","56353","4500","90521","7621","158995"
"2021/07/28","45608","14500","68285","1293","129686"
"2021/07/27","24507","10057","74720","1249","110533"
"2021/07/26","20395","5043","35919","71","61428"
"2021/07/23","40576","0","26327","8735","75638"
"2021/07/22","11036","110","40508","5507","57161"
"2021/07/21","9876","15","19883","209","29983"
"2021/07/20","28775","0","29739","4184","62698"
"2021/07/19","43968","0","36301","342","80611"
"2021/07/16","7819","0","32198","3029","43046"
"2021/07/15","62622","4788","78246","4518","150174"
"2021/07/14","34991","10600","34459","5","80055"
"2021/07/13","11379","0","28987","358","40724"
"2021/07/12","23442","0","32699","961","57102"
"2021/07/09","49663","35","43649","3210","96557"
"2021/07/08","37870","3","75274","7632","120779"
"2021/07/07","40027","1912","32351","8470","82760"
"2021/07/06","17206","2517","45689","2635","68047"
"2021/07/05","22796","100","52434","9970","85300"
"2021/07/02","28160","11300","54712","4088","98260"
"2021/07/01","27169","5083","42098","3219","77569"
"2021/06/30","32416","10000","43079","4945","90440"
"2021/06/29","39138","165","57719","103","97125"
"2021/06/28","62144","0","36575","0","98719"
"2021/06/25","49997","7700","20430","1228","79355"
"2021/06/24","37516","18441","21994","5206","83157"
"2021/06/23","125020","16353","49066","10907","201346"
"2021/06/22","13002","9978","20255","0","43235"
"2021/06/21","37346","4631","47654","15804","105435"
"2021/06/18","24103","4020","91003","8972","128098"
"2021/06/17","23534","5435","41878","1903","72750"
"2021/06/16","27960","1236","97274","24249","150719"
"2021/06/15","63186","4114","152711","7926","227937"
"2021/06/14","45702","2488","153519","3137","204846"
"2021/06/11","101362","2592","118182","2045","224181"
"2021/06/10","21533","1787","31445","1159","55924"
"2021/06/09","125499","5311","33002","20378","184190"
"2021/06/08","47027",,"37132","4408","88567"
"2021/06/07","47433","0","85837","0","133270"
"2021/06/04","43750","5109","62258","3422","114539"
"2021/06/03","66580","23","175785","17371","259759"
"2021/06/02","93672","10171","156820","45267","305930"
"2021/06/01","194771","2791","214616","57139","469317"
"2021/05/31","206388","5000","141079","21293","373760"
"2021/05/28","124757","6841","96652","12828","241078"
"2021/05/27","95093","5755","190038","17349","308235"
"2021/05/26","31002","1026","94383","502","126913"
"2021/05/25","43175","2789","114611","4463","165038"
"2021/05/24","94106","1059","69402","18592","183159"
"2021/05/21","109675","2388","130708","6189","248960"
"2021/05/20","46338","2240","129897","8252","186727"
"2021/05/18","56375","1168","72472","3786","133801"
"2021/05/17","36220","8019","58625","1717","104581"
"2021/05/14","39584","5841","142460","7129","195014"
"2021/05/13","63480","8654","195178","21499","288811"
"2021/05/12","151420","6440","108944","9167","275971"
"2021/05/11","139778","5142","142723","12580","300223"
"2021/05/10","110938","1240","193900","28792","334870"
"2021/05/07","58108","9","138091","19831","216039"
"2021/05/06","60859","665","198132","46555","306211"
"2021/05/04","60327","5","124633","8978","193943"
"2021/05/03","56537","461","148078","30670","235746"
"2021/04/30","72566","374","83414","9429","165783"
"2021/04/29","88664","136","81243","5425","175468"
"2021/04/28","62888","59","69000","18742","150689"
"2021/04/27","64355","13431","65512","3184","146482"
"2021/04/26","78032","1","69884","2317","150234"
"2021/04/23","75689","1","77220","18437","171347"
"2021/04/22","94340","106","138982","45574","279002"
"2021/04/21","106248","703","138079","6385","251415"
"2021/04/20","66331","24165","137866","45660","274022"
"2021/04/19","41585","5093","108732","14618","170028"
"2021/04/16","73594","7618","106721","19705","207638"
"2021/04/15","83758","17052","36282","8233","145325"
"2021/04/14","35186","3","65734","614","101537"
"2021/04/13","54254","4","28908","106","83272"
"2021/04/12","41022","0","66988","129","108139"
"2021/04/09","55379","3","61366","5553","122301"
"2021/04/08","49305","9972","138729","2040","200046"
"2021/04/07","73493","1025","109618","7272","191408"
"2021/04/06","73801","19013","85129","28067","206010"
"2021/04/05","60580","4685","112035","47044","224344"
"2021/04/02","90737","7","81581","27873","200198"
"2021/04/01","214601","35111","71854","6498","328064"
"2021/03/31","73636","1110","197231","48277","320254"
"2021/03/30","64490","552","56259","42361","163662"
"2021/03/29","111765","2","80683","7632","200082"
"2021/03/26","248156","0","51117","44260","343533"
"2021/03/25","120727","2453","169946","26528","319654"
"2021/03/24","63214","4013","50586","3294","121107"
"2021/03/23","91253","12","64423","2765","158453"
"2021/03/22","57270","4129","283679","59084","404162"
"2021/03/19","32038","16201","83815","284913","416967"
"2021/03/18","26300","21800","50680","55721","154501"
"2021/03/17","48705","8250","58999","88315","204269"
"2021/03/16","50816","329","45516","100699","197360"
"2021/03/15","7030","1129","44336","50183","102678"
"2021/03/12","21046","41806","45211","6868","114931"
"2021/03/11","10379","1827","31723","113","44042"
"2021/03/10","18346","1003","23600","6071","49020"
"2021/03/09","21981","1577","38933","15524","78015"
"2021/03/08","23911","3185","93613","23234","143943"
"2021/03/05","17308","1446","53165","8725","80644"
"2021/03/04","14009","6001","25181","3973","49164"
"2021/03/03","6340","200","25751","26","32317"
"2021/03/02","5341","3","46337","2073","53754"
"2021/02/26","15399","35420","36799","33226","120844"
"2021/02/25","11994","57132","8401","18493","96020"
"2021/02/24","14571","30167","19512","5484","69734"
"2021/02/23","18304","7211","65869","16744","108128"
"2021/02/22","28202","30250","54767","2720","115939"
"2021/02/19","18876","5001","39097","108","63082"
"2021/02/18","31601","2","21300","731","53634"
"2021/02/17","38352","0","69237","4358","111947"
"2021/02/16","46406","2000","40688","335","89429"
"2021/02/15","65568","3014","31924","468","100974"
"2021/02/10","13972","0","35752","76","49800"
"2021/02/09","43450","8035","54063","544","106092"
"2021/02/08","17547","10037","74280","2777","104641"
"2021/02/05","14232","0","50303","2159","66694"
"2021/02/04","15457","200","48149","377","64183"
"2021/02/03","14868","9050","40818","2974","67710"
"2021/02/02","21335","16200","79290","2012","118837"
"2021/02/01","35212","3600","32049","70","70931"
"2021/01/29","46452","7000","31947","3357","88756"
"2021/01/28","30029","3000","29976","391","63396"
"2021/01/27","30764","4000","50651","13207","98622"
"2021/01/26","18951","32500","67661","12642","131754"
"2021/01/25","18554","33586","22694","0","74834"
"2021/01/22","42812","32126","81562","19130","175630"
"2021/01/21","39376","55963","30016","5970","131325"
"2021/01/20","42397","43368","18721","11539","116025"
"2021/01/19","22336","37005","75189","555","135085"
"2021/01/18","19735","16320","88458","655","125168"
"2021/01/15","30029","19007","59243","6240","114519"
"2021/01/14","18414","6000","45826","4646","74886"
"2021/01/13","128757","16555","52497","5642","203451"
"2021/01/12","26436","3500","73227","0","103163"
"2021/01/11","49085","1000","99101","52003","201189"
"2021/01/08","80167","23984","50127","1561","155839"
"2021/01/07","157429","5000","35055","5965","203449"
"2021/01/06","157384","1528","51481","26983","237376"
"2021/01/05","98432","0","117393","19279","235104"
"2021/01/04","132793","89901","74556","1836","299086"
"2020/12/30","6913","57096","52554","7095","123658"
"2020/12/29","39014","0","15544","8056","62614"
"2020/12/28","20732","28206","96772","41518","187228"
"2020/12/24","30980","32513","114389","50132","228014"
"2020/12/23","13864","25791","70759","10002","120416"
"2020/12/22","9247","24260","60051","3859","97417"
"2020/12/21","46702","70699","59188","8103","184692"
"2020/12/18","60027","64095","105187","1002","230311"
"2020/12/17","29354","344","36898","0","66596"
"2020/12/16","9752","400","27339","5394","42885"
"2020/12/15","156243","800","13518","4132","174693"
"2020/12/14","209272","102","12945","314","222633"
"2020/12/11","612354","1809","26677","26287","667127"
"2020/12/10","77882","68159","87596","5295","238932"
"2020/12/09","55292","20","7817","76","63205"
"2020/12/08","33353","20","17060","10474","60907"
"2020/12/07","57673","1705","111640","6563","177581"
"2020/12/04","11718","5","58424","3333","73480"
"2020/12/03","13254","298","53581","1","67134"
"2020/12/02","18435","0","52575","8495","79505"
"2020/12/01","81705","3000","197380","13786","295871"
"2020/11/30","35752","0","58989","6003","100744"
"2020/11/27","91404","7500","251950","24503","375357"
"2020/11/26","32605","106727","247923","39210","426465"
"2020/11/25","61365","17500","223566","29394","331825"
"2020/11/24","47338","11400","168697","33388","260823"
"2020/11/23","71645","28000","155686","3853","259184"
"2020/11/20","18439","0","53385","100","71924"
"2020/11/19","25352","27000","128985","8084","189421"
"2020/11/18","21360","8100","74773","11954","116187"
"2020/11/17","25932","500","42068","3097","71597"
"2020/11/16","46127","4000","68023","790","118940"
"2020/11/13","21420","2000","70071","3478","96969"
"2020/11/12","25883","15500","82633","7621","131637"
"2020/11/11","21049","8030","151751","15089","195919"
"2020/11/10","10428","20000","102527","11138","144093"
"2020/11/09","22193","11500","23490","2068","59251"
"2020/11/06","31377","27000","52942","4804","116123"
"2020/11/05","8400","11000","45592","3695","68687"
"2020/11/04","15147","29149","50827","5540","100663"
"2020/11/03","26930","4000","86074","1001","118005"
"2020/11/02","17020","0","138831","1937","157788"
"2020/10/30","34149","0","52543","3705","90397"
"2020/10/29","18702","16001","73270","1","107974"
"2020/10/28","20305","39814","48604","4420","113143"
"2020/10/27","29243","4000","112422","10804","156469"
"2020/10/26","38037","33012","162589","6469","240107"
"2020/10/23","17674","41219","235187","23215","317295"
"2020/10/22","35768","103242","148450","8600","296060"
"2020/10/21","22027","75406","126447","5110","228990"
"2020/10/20","24712","22129","70938","4201","121980"
"2020/10/19","89421","10818","98342","11130","209711"
"2020/10/16","15174","205","68491","7563","91433"
"2020/10/15","9639","205","49316","1647","60807"
"2020/10/14","20779","28261","115054","9008","173102"
"2020/10/13","41443","513","34694","6067","82717"
"2020/10/12","6683","1293","108803","3562","120341"
"2020/10/08","37467","15422","125743","7653","186285"
"2020/10/07","14980","7089","59493","1","81563"
"2020/10/06","20695","3000","75356","3034","102085"
"2020/10/05","37438","52179","78972","15261","183850"
"2020/09/29","24597","8097","32376","3008","68078"
"2020/09/28","31271","43600","57036","0","131907"
"2020/09/25","58033","1000","61781","5457","126271"
"2020/09/24","47306","23978","56331","8000","135615"
"2020/09/23","13068","22217","33031","4847","73163"
"2020/09/22","32623","0","62457","4715","99795"
"2020/09/21","29985","24106","155492","3156","212739"
"2020/09/18","55401","13740","66864","8633","144638"
"2020/09/17","31728","44618","100209","8791","185346"
"2020/09/16","80593","4625","71021","9486","165725"
"2020/09/15","43864","10237","69505","1001","124607"
"2020/09/14","26268","3274","96514","3","126059"
"2020/09/11","5391","31276","154454","12303","203424"
"2020/09/10","28488","0","95832","934","125254"
"2020/09/09","34203","40","97289","1","131533"
"2020/09/08","21749","100","137155","3885","162889"
"2020/09/07","65229","74525","162771","3","302528"
"2020/09/04","35489","35863","228272","4236","303860"
"2020/09/03","88570","10673","328074","2972","430289"
"2020/09/02","83986","220","197224","558","281988"
"2020/09/01","190300","68346","258810","9233","526689"
"2020/08/31","737399","117006","2010032","16716","2881153"