일자,기관 합계,기타법인,개인,외국인 합계,전체
"2023/05/04","363454910","0","449249600","145032660","957737170"
"2023/05/03","111831265","0","134244000","27944690","274019955"
"2023/05/02","44379820","310905","196605455","30363280","271659460"
"2023/04/28","35247180","0","194556595","32448835","262252610"
"2023/04/27","213790270","0","140725825","124997275","479513370"
"2023/04/26","120255200","0","195434220","41646760","357336180"
"2023/04/25","594718240","0","148125100","115612615","858455955"
"2023/04/24","651018045","0","193229230","104414015","948661290"
"2023/04/21","705246770","0","200819735","177559950","1083626455"
"2023/04/20","627163045","11119300","334185400","171161635","1143629380"
"2023/04/19","341698270","17730640","123194190","134559260","617182360"
"2023/04/18","388589835","102703800","394268805","60856830","946419270"
"2023/04/17","386843290","2010000","166747475","150811160","706411925"
"2023/04/14","1031060660","0","190933055","14198720","1236192435"
"2023/04/13","267075330","0","198533250","79736670","545345250"
"2023/04/12","258617575","891780","271813045","9102060","540424460"
"2023/04/11","153368365","0","258976130","75496555","487841050"
"2023/04/10","117647915","173312695","201690850","39379340","532030800"
"2023/04/07","65203290","89140825","117918425","47974385","320236925"
"2023/04/06","141170870","178704785","461702620","103834945","885413220"
"2023/04/05","346194290","24014330","153090255","89942495","613241370"
"2023/04/04","388833250","112438555","263189160","42658230","807119195"
"2023/04/03","326963320","10470160","223585315","121865160","682883955"
"2023/03/31","396966445","10406240","136593890","74928315","618894890"
"2023/03/30","90473130","0","143642270","52985400","287100800"
"2023/03/29","149222120","0","169869210","61499180","380590510"
"2023/03/28","453956050","255300","358017700","86886640","899115690"
"2023/03/27","381102575","66757920","365388540","57594715","870843750"
"2023/03/24","127811180","28624975","84821655","81586050","322843860"
"2023/03/23","189971910","0","131504410","32208990","353685310"
"2023/03/22","227715060","0","199366250","30805240","457886550"
"2023/03/21","168943985","0","139840570","86764925","395549480"
"2023/03/20","225782925","0","202729135","140647395","569159455"
"2023/03/17","215727980","4980","154138090","397154805","767025855"
"2023/03/16","179843680","0","129819430","32288170","341951280"
"2023/03/15","384261725","6342100","77696805","33563440","501864070"
"2023/03/14","195506150","39848390","200022460","126014760","561391760"
"2023/03/13","197920440","0","209499510","44275300","451695250"
"2023/03/10","187690790","0","180163380","46507700","414361870"
"2023/03/09","122061350","2550860","75540010","3839900","203992120"
"2023/03/08","193478310","0","161299600","13649060","368426970"
"2023/03/07","191181340","37501810","135470470","51397330","415550950"
"2023/03/06","143019410","2503680","100782710","41230560","287536360"
"2023/03/03","112022080","0","95407340","29400890","236830310"
"2023/03/02","156673180","0","105363800","43419620","305456600"
"2023/02/28","96189570","0","150223490","60034290","306447350"
"2023/02/27","202264840","1018000","75763090","119569820","398615750"
"2023/02/24","383965180","0","266606080","154495830","805067090"
"2023/02/23","196617810","0","167845060","109814080","474276950"
"2023/02/22","252308210","0","147558510","26102880","425969600"
"2023/02/21","250862620","0","180297530","54379480","485539630"
"2023/02/20","109158310","0","135746080","31669510","276573900"
"2023/02/17","135794030","2782540","151355560","10669790","300601920"
"2023/02/16","186489930","1155830","278920500","27592370","494158630"
"2023/02/15","210834840","15582630","110380220","5924980","342722670"
"2023/02/14","278202750","968530","99862510","6489400","385523190"
"2023/02/13","290900260","0","113367310","22532700","426800270"
"2023/02/10","356920040","410250","152125500","62569550","572025340"
"2023/02/09","206237180","2715420","146895010","14235180","370082790"
"2023/02/08","449836340","0","171806400","9666510","631309250"
"2023/02/07","361934800","23867110","206779190","50883520","643464620"
"2023/02/06","336017600","3380400","183816810","100195190","623410000"
"2023/02/03","640904280","54555000","469419150","218220770","1383099200"
"2023/02/02","413452360","20707250","267521040","62922540","764603190"
"2023/02/01","218748440","0","165162210","21391310","405301960"
"2023/01/31","468324930","0","230654080","324660260","1023639270"
"2023/01/30","267104090","26810820","258328090","45401300","597644300"
"2023/01/27","233436440","0","113652920","81170560","428259920"
"2023/01/26","195589620","19329060","287372010","80045920","582336610"
"2023/01/25","185693810","15920140","415421720","67775460","684811130"
"2023/01/20","357704150","5431000","276201330","36357130","675693610"
"2023/01/19","274689190","0","258409390","36540410","569638990"
"2023/01/18","477940730","540000","110525850","12561260","601567840"
"2023/01/17","327523630","0","207494260","37021690","572039580"
"2023/01/16","236908940","0","228135840","220686590","685731370"
"2023/01/13","121927300","546000","196976900","111425870","430876070"
"2023/01/12","198181220","0","116752590","45412840","360346650"
"2023/01/11","99839610","0","171460140","118906320","390206070"
"2023/01/10","178330900","16590000","189899790","112827660","497648350"
"2023/01/09","294863580","16879000","554526460","221284360","1087553400"
"2023/01/06","263789170","23851910","341227840","158626860","787495780"
"2023/01/05","677006810","2988090","429719140","108459740","1218173780"
"2023/01/04","323874630","0","291741510","87543750","703159890"
"2023/01/03","160492840","345330","406231980","152709130","719779280"
"2023/01/02","270820630","534000","242827630","186616530","700798790"
"2022/12/29","1047730770","1429260","555519620","103286080","1707965730"
"2022/12/28","477381150","7374140","195263450","4139900","684158640"
"2022/12/27","419873140","10232120","215229700","118340990","763675950"
"2022/12/26","424472040","0","254002210","50695180","729169430"
"2022/12/23","969257080","0","450543890","165228240","1585029210"
"2022/12/22","1007676970","550000","625065320","422695310","2055987600"
"2022/12/21","725690360","540000","466860240","31592490","1224683090"
"2022/12/20","724750570","830530","248694030","180119170","1154394300"
"2022/12/19","584155190","12816000","477013400","361075820","1435060410"
"2022/12/16","5572321700","110168280","3954802430","16392544630","26029837040"
"2022/12/15","1386227680","125891580","457097960","919551660","2888768880"
"2022/12/14","1541156880","0","251537970","605564530","2398259380"
"2022/12/13","472285850","0","224481750","169316090","866083690"
"2022/12/12","773471600","22870450","279349300","304435560","1380126910"
"2022/12/09","972409390","27206460","549739450","432618780","1981974080"
"2022/12/08","1409944150","87919130","887339860","389257750","2774460890"
"2022/12/07","721880430","194163470","678531600","322614560","1917190060"
"2022/12/06","1868031050","10824480","1375476105","700259410","3954591045"
"2022/12/05","2948031815","245884945","3683654535","1049783765","7927355060"
"2022/12/02","327151350","0","238065650","122075900","687292900"
"2022/12/01","608668855","740335","679260235","65947810","1354617235"
"2022/11/30","235991350","305761960","474810675","35570765","1052134750"
"2022/11/29","168454220","0","212663845","27007750","408125815"
"2022/11/28","360364980","897000","110752345","51989085","524003410"
"2022/11/25","664647095","9164510","156421955","37683675","867917235"
"2022/11/24","615562155","0","102939860","45675575","764177590"
"2022/11/23","294264250","6271140","111625445","21583440","433744275"
"2022/11/22","293894740","0","99532610","29451405","422878755"
"2022/11/21","321440075","0","137499030","69910095","528849200"
"2022/11/18","370263720","2300915","73028435","51632025","497225095"
"2022/11/17","277438925","0","143748260","71856660","493043845"
"2022/11/16","373495480","0","118937110","38423970","530856560"
"2022/11/15","458234800","0","155844930","121951445","736031175"
"2022/11/14","497460180","0","242906815","193585820","933952815"
"2022/11/11","1259441810","2346250","666333420","134031955","2062153435"
"2022/11/10","568272230","254000","230529965","13478420","812534615"
"2022/11/09","529559750","0","82203205","73245125","685008080"
"2022/11/08","716769960","0","166985180","100276610","984031750"
"2022/11/07","694697190","227500","239390130","52906445","987221265"
"2022/11/04","453139595","0","218556370","79865250","751561215"
"2022/11/03","423414225","0","164932785","58704980","647051990"
"2022/11/02","432698965","228500","91814390","104983415","629725270"
"2022/11/01","651433225","2291500","119361325","49952420","823038470"
"2022/10/31","567250065","0","137865950","14327135","719443150"
"2022/10/28","597993260","0","101392755","52062725","751448740"
"2022/10/27","354812965","0","216283925","73780970","644877860"
"2022/10/26","281365355","19882105","158881145","53884965","514013570"
"2022/10/25","287388295","0","222250750","54818050","564457095"
"2022/10/24","286233145","1567910","183148535","35217125","506166715"
"2022/10/21","390563005","137167875","303882590","92911955","924525425"
"2022/10/20","1017377390","26451270","188918710","157442355","1390189725"
"2022/10/19","518205725","58461145","560386160","225248520","1362301550"
"2022/10/18","1793215680","107239650","606725430","329422265","2836603025"
"2022/10/17","1193558300","1051005","571508215","294022980","2060140500"
"2022/10/14","928485995","2386915","603393125","121713700","1655979735"
"2022/10/13","1131898595","46200000","417602845","111825880","1707527320"
"2022/10/12","351810435","1281040","273892435","64248055","691231965"
"2022/10/11","172068295","6709275","765486745","68959645","1013223960"
"2022/10/07","252364305","0","306432585","44085660","602882550"
"2022/10/06","441864775","332522200","179438315","55058090","1008883380"
"2022/10/05","551015435","23895000","347404285","67648045","989962765"
"2022/10/04","362570485","317360425","379849940","71658260","1131439110"
"2022/09/30","178682880","126376180","425970020","68980630","800009710"
"2022/09/29","215332310","0","396531230","31641130","643504670"
"2022/09/28","503486570","0","533786570","110590090","1147863230"
"2022/09/27","504436330","629520","212343390","186233520","903642760"
"2022/09/26","445777240","19335990","708062030","208906400","1382081660"
"2022/09/23","393101120","582216620","576762930","66475010","1618555680"
"2022/09/22","270071730","25318270","637948940","70247950","1003586890"
"2022/09/21","219190920","35897490","220570230","29292530","504951170"
"2022/09/20","435312940","27867030","250064880","47530170","760775020"
"2022/09/19","237999780","177870630","243622660","32512980","692006050"
"2022/09/16","379926210","625089380","852238470","14939351950","16796606010"
"2022/09/15","225807270","94254080","542218910","515885440","1378165700"
"2022/09/14","329042370","15413510","485875680","1222110200","2052441760"
"2022/09/13","111942170","38820000","472044320","675011680","1297818170"
"2022/09/08","267481680","48226060","551612260","670585750","1537905750"
"2022/09/07","480023570","41093780","952231020","161945560","1635293930"
"2022/09/06","794836900","150213080","980153320","701181510","2626384810"
"2022/09/05","233877440","26256200","850067460","571228750","1681429850"
"2022/09/02","964948070","14764120","1052235870","131763020","2163711080"
"2022/09/01","296718640","44605770","1385504500","281299160","2008128070"
"2022/08/31","157928300","0","1207414090","188530700","1553873090"
"2022/08/30","260053450","1179220","951510780","176336210","1389079660"
"2022/08/29","859845410","11080000","2524283620","625068150","4020277180"
"2022/08/26","2691018320","9055090","3168406400","372211370","6240691180"
"2022/08/25","1082111960","118056050","1967913940","413464280","3581546230"
"2022/08/24","1099977660","205928220","4896482060","595940550","6798328490"
"2022/08/23","1200384420","18332070","1291568010","277316930","2787601430"
"2022/08/22","1090495260","4161190","1829739050","170590840","3094986340"
"2022/08/19","26396740","0","602211330","19518640","648126710"
"2022/08/18","88000710","0","311094510","5327170","404422390"
"2022/08/17","230606090","56343620","180327350","163157630","630434690"
"2022/08/16","240330210","0","167998620","386326540","794655370"
"2022/08/12","371435140","86841990","277663790","68677520","804618440"
"2022/08/11","433983960","49211770","286167020","123266940","892629690"
"2022/08/10","210864300","1100000","264576630","138763410","615304340"
"2022/08/09","284546150","0","256116650","173416090","714078890"
"2022/08/08","180981100","0","201969230","211689260","594639590"
"2022/08/05","244103110","353040","498534870","380980720","1123971740"
"2022/08/04","254568550","16682200","847271520","280555460","1399077730"
"2022/08/03","270882920","29247450","399793800","345488440","1045412610"
"2022/08/02","292049070","1294400","757774650","237044760","1288162880"
"2022/08/01","688144940","4462450","841503030","323542270","1857652690"
"2022/07/29","511376470","10283030","617477070","233825560","1372962130"
"2022/07/28","358309750","263500","488177620","129840720","976591590"
"2022/07/27","810282330","156600","464839130","36419250","1311697310"
"2022/07/26","1014620970","0","418398050","150123930","1583142950"
"2022/07/25","988793350","0","275173760","368595910","1632563020"
"2022/07/22","1524154200","1165000","783585880","219958030","2528863110"
"2022/07/21","3415030900","0","821741340","241384640","4478156880"
"2022/07/20","4566349280","16200","629692940","276464180","5472522600"
"2022/07/19","1110072570","40831370","426874080","122545940","1700323960"
"2022/07/18","1032176300","0","197033340","80092040","1309301680"
"2022/07/15","619057180","3348000","203462810","226487750","1052355740"
"2022/07/14","409070310","0","183771270","235258180","828099760"
"2022/07/13","382960810","3067200","360141810","538364540","1284534360"
"2022/07/12","77830880","0","316744500","382625320","777200700"
"2022/07/11","157689850","1148000","267582850","279577950","705998650"
"2022/07/08","49018500","37177810","146280750","568946940","801424000"
"2022/07/07","410210070","0","399907560","472817910","1282935540"
"2022/07/06","2238119990","0","469725390","532432790","3240278170"
"2022/07/05","2188935460","8385870","530649500","332425730","3060396560"
"2022/07/04","2435675150","5404070","691376780","588288420","3720744420"
"2022/07/01","2979572770","41723990","664640110","626966580","4312903450"
"2022/06/30","2811080070","0","402142390","213770250","3426992710"
"2022/06/29","231117640","0","343416000","539896110","1114429750"
"2022/06/28","741019600","12871050","900786390","572579940","2227256980"
"2022/06/27","1450025480","930160","400503050","198414800","2049873490"
"2022/06/24","1022446050","5971160","183952590","278663380","1491033180"
"2022/06/23","2274806280","0","528283510","389819000","3192908790"
"2022/06/22","926587450","644550460","1175167590","408808240","3155113740"
"2022/06/21","1350304020","143577690","425089560","210664080","2129635350"
"2022/06/20","978413130","22332000","1600733630","166529230","2768007990"
"2022/06/17","499843470","10517760","549030720","231184250","1290576200"
"2022/06/16","312210920","0","231651090","324865850","868727860"
"2022/06/15","188085900","87100","524699270","309124550","1021996820"
"2022/06/14","1073599950","33410","1005997520","114230340","2193861220"
"2022/06/13","690394550","30760000","872531740","103891440","1697577730"
"2022/06/10","1074760710","0","165250880","166526750","1406538340"
"2022/06/09","50458910","0","433081180","116907340","600447430"
"2022/06/08","442808520","5873200","428551550","273220020","1150453290"
"2022/06/07","106033900","0","529351960","275204850","910590710"
"2022/06/03","432805370","1388000","509427820","467589940","1411211130"
"2022/06/02","276711610","128871300","271049600","619249820","1295882330"
"2022/05/31","151330580","1095138470","381067020","3684674650","5312210720"
"2022/05/30","692216560","1781640990","564553040","403626630","3442037220"
"2022/05/27","517544810","258800430","586581380","365031180","1727957800"
"2022/05/26","715153720","197396900","802708400","282771180","1998030200"
"2022/05/25","406716960","232447130","961948250","142567550","1743679890"
"2022/05/24","259973430","170769800","784627890","53475200","1268846320"
"2022/05/23","278467680","10610000","581717170","94519980","965314830"
"2022/05/20","462720010","0","591739410","208370300","1262829720"
"2022/05/19","101925980","0","429820950","204189250","735936180"
"2022/05/18","565418640","35495350","428758360","325406960","1355079310"
"2022/05/17","529692790","0","295934190","265932090","1091559070"
"2022/05/16","363931080","51528200","1131887090","154751270","1702097640"
"2022/05/13","260972830","187066880","663980800","345708230","1457728740"
"2022/05/12","426881280","70002400","447472580","171045530","1115401790"
"2022/05/11","310345570","35354730","309955410","397026680","1052682390"
"2022/05/10","2108986960","16731080","1303670050","363946100","3793334190"
"2022/05/09","89006550","37984930","407205970","115449120","649646570"
"2022/05/06","260997690","12945560","732013920","82826000","1088783170"
"2022/05/04","761420960","0","1216665930","186411300","2164498190"
"2022/05/03","1062789870","7130","1212653490","67493690","2342944180"
"2022/05/02","1233916580","78120000","696264170","70440750","2078741500"
"2022/04/29","846384160","73068000","1084308720","198094060","2201854940"
"2022/04/28","2346608020","29036930","1766565660","350821380","4493031990"
"2022/04/27","1042698480","203840270","1931073970","454344340","3631957060"
"2022/04/26","1238949840","36235200","990970050","226158200","2492313290"
"2022/04/25","532676010","20155000","1178289550","136079130","1867199690"
"2022/04/22","911710020","4141000","564385150","38412500","1518648670"
"2022/04/21","565818670","8360790","1030375340","155587440","1760142240"
"2022/04/20","694809520","10841800","741238640","346101360","1792991320"
"2022/04/19","1192741040","0","657579410","415146370","2265466820"
"2022/04/18","1789382920","76066510","1468400570","681287350","4015137350"
"2022/04/15","1608353780","21238000","1868395490","218912510","3716899780"
"2022/04/14","1137643640","75071480","805293700","66608860","2084617680"
"2022/04/13","1187154360","204751920","1322359030","684609120","3398874430"
"2022/04/12","519606350","821693480","1629414720","99856570","3070571120"
"2022/04/11","922113100","305404820","1254781130","46795480","2529094530"
"2022/04/08","1300170310","240431000","616349490","64077430","2221028230"
"2022/04/07","1688112120","4500980","430574030","65970160","2189157290"
"2022/04/06","1519119210","72612430","591643600","99546530","2282921770"
"2022/04/05","1445186700","98645500","734847610","27181530","2305861340"
"2022/04/04","809704970","96900000","997194640","29005390","1932805000"
"2022/04/01","489583920","84019370","621576480","48955240","1244135010"
"2022/03/31","1065080330","64720500","702005720","13685940","1845492490"
"2022/03/30","647065810","0","1067824460","94726100","1809616370"
"2022/03/29","624072860","5136000","1340383030","86014200","2055606090"
"2022/03/28","478798610","135196360","882446050","28577940","1525018960"
"2022/03/25","995067660","33607950","385378230","80999040","1495052880"
"2022/03/24","740018010","149704000","458114650","37608980","1385445640"
"2022/03/23","514553110","5144000","805453120","149669090","1474819320"
"2022/03/22","799433160","160500000","912924900","111777650","1984635710"
"2022/03/21","605940030","99628000","684887680","214960430","1605416140"
"2022/03/18","697304990","1400087450","548293200","2151805010","4797490650"
"2022/03/17","188706450","1390699110","381410930","22608550","1983425040"
"2022/03/16","483143960","1386660250","770576650","148697430","2789078290"
"2022/03/15","177074490","1399053840","382512090","48845770","2007486190"
"2022/03/14","1973172750","1385377740","569686940","179468400","4107705830"
"2022/03/11","1356082850","1515750","1472520190","162263110","2992381900"
"2022/03/10","264587440","83650000","1149658720","116689240","1614585400"
"2022/03/08","338311170","0","1423266480","96841380","1858419030"
"2022/03/07","257140570","202240","948086490","57893350","1263322650"
"2022/03/04","182000010","0","806878190","32775300","1021653500"
"2022/03/03","103035300","0","1104527210","9461440","1217023950"
"2022/03/02","1101718180","0","538887990","148201090","1788807260"
"2022/02/28","289560580","0","386970020","58200530","734731130"
"2022/02/25","456184860","0","619598800","7129040","1082912700"
"2022/02/24","60132110","743000","649897570","8978430","719751110"
"2022/02/23","382836120","1658070","752881400","7448620","1144824210"
"2022/02/22","290857840","0","742537360","1665140","1035060340"
"2022/02/21","419254010","1252510","417203750","2830440","840540710"
"2022/02/18","315642500","0","357365580","26069230","699077310"
"2022/02/17","347717130","0","436174000","30154780","814045910"
"2022/02/16","344978710","0","452462510","2699180","800140400"
"2022/02/15","50882420","619000","965097250","46796320","1063394990"
"2022/02/14","32928870","367800","786791630","13053960","833142260"
"2022/02/11","78228070","0","492474870","11203530","581906470"
"2022/02/10","373159830","0","532506330","6295020","911961180"
"2022/02/09","669184140","34931050","375622270","31987450","1111724910"
"2022/02/08","588531690","42793890","238297060","167608310","1037230950"
"2022/02/07","426611600","430500","460317230","101296630","988655960"
"2022/02/04","559619690","2562560","485902960","110288180","1158373390"
"2022/02/03","603185730","11536020","790399530","11308040","1416429320"
"2022/01/28","469957160","9879650","680460860","123220710","1283518380"
"2022/01/27","1031723960","0","924690520","143287430","2099701910"
"2022/01/26","448164350","0","410748710","18761500","877674560"
"2022/01/25","271110170","2114000","1068284360","3767090","1345275620"
"2022/01/24","92326280","131549560","757882040","90821870","1072579750"
"2022/01/21","236015560","6100000","522263500","14111070","778490130"
"2022/01/20","29155330","18246080","478583380","46685910","572670700"
"2022/01/19","163984240","0","556908660","67110850","788003750"
"2022/01/18","478437500","0","460381020","85606480","1024425000"
"2022/01/17","196724600","85540","577210590","52527890","826548620"
"2022/01/14","270412590","42770000","733115470","45448450","1091746510"
"2022/01/13","232433980","6100000","527007840","124861250","890403070"
"2022/01/12","211223470","0","762305370","60496720","1034025560"
"2022/01/11","270727560","0","823811070","73372120","1167910750"
"2022/01/10","288862840","0","1043504630","214444680","1546812150"
"2022/01/07","735044800","80705480","680404480","43391070","1539545830"
"2022/01/06","412602950","27650000","651279820","257245440","1348778210"
"2022/01/05","263551620","25030500","944846540","197931340","1431360000"
"2022/01/04","671219200","368340430","640325130","158490990","1838375750"
"2022/01/03","199752920","0","1341663460","185949990","1727366370"
"2021/12/30","66799630","0","459125930","32801370","558726930"
"2021/12/29","450425800","27122330","660892920","44091210","1182532260"
"2021/12/28","157212540","3720000","910558650","78824540","1150315730"
"2021/12/27","308564310","0","504187370","202834730","1015586410"
"2021/12/24","561782000","0","813527550","93722240","1469031790"
"2021/12/23","592876250","137280","654884120","127412380","1375310030"
"2021/12/22","786097050","0","862062080","351652410","1999811540"
"2021/12/21","5405773570","9500000","5824139230","1216449520","12455862320"
"2021/12/20","3762488780","1077544630","6426217330","716205930","11982456670"
"2021/12/17","1498809920","35165540","414815900","178807490","2127598850"
"2021/12/16","1090779640","181786040","428171930","26895100","1727632710"
"2021/12/15","1180070350","38515000","368572650","52876980","1640034980"
"2021/12/14","3458503120","380846100","493723540","296819120","4629891880"
"2021/12/13","265036650","0","1059126590","52033910","1376197150"
"2021/12/10","952074060","23356330","704214350","14098330","1693743070"
"2021/12/09","862491590","29550","521198130","4193210","1387912480"
"2021/12/08","404963150","0","368465900","485339420","1258768470"
"2021/12/07","492218810","0","428593350","68585570","989397730"
"2021/12/06","344350900","0","981526600","115465550","1441343050"
"2021/12/03","1456027300","72094200","1169186240","32458210","2729765950"
"2021/12/02","1769344560","0","1018755150","221352310","3009452020"
"2021/12/01","34961620","2995000","1095738610","180448310","1314143540"
"2021/11/30","875158760","0","1236884820","661221370","2773264950"
"2021/11/29","197963870","386200","2311340310","135085650","2644776030"
"2021/11/26","735659810","61000","1435824320","83417060","2254962190"
"2021/11/25","695573750","0","492213210","44204720","1231991680"
"2021/11/24","697151490","10438000","767726160","179083890","1654399540"
"2021/11/23","279384410","77636560","1024133320","61415030","1442569320"
"2021/11/22","112863130","29997930","1158351440","48062000","1349274500"
"2021/11/19","552961480","30755000","1138520320","39880640","1762117440"
"2021/11/18","422275950","65396400","1091602920","121365940","1700641210"
"2021/11/17","239113380","180220000","889194260","363677120","1672204760"
"2021/11/16","236490940","6827420","1270754680","41666690","1555739730"
"2021/11/15","167784870","0","1292277030","80409670","1540471570"
"2021/11/12","16855620","0","1576427440","30459770","1623742830"
"2021/11/11","100245760","12560000","1307230080","28383840","1448419680"
"2021/11/10","130555130","169087060","1247186360","136576170","1683404720"
"2021/11/09","77387940","0","1525619470","117498580","1720505990"
"2021/11/08","55211610","13010660","1404575850","297492570","1770290690"
"2021/11/05","221541490","65706940","1073690030","212798830","1573737290"
"2021/11/04","275391350","454166940","2445767510","51754840","3227080640"
"2021/11/03","343512370","1142173240","3083474680","240402360","4809562650"
"2021/11/02","356059060","636143990","2114097800","9435580","3115736430"
"2021/11/01","198705320","1094392710","2515980820","289655970","4098734820"
"2021/10/29","119740510","330207170","1870216450","18971100","2339135230"
"2021/10/28","182203250","131270960","2262328470","52334320","2628137000"
"2021/10/27","864656420","137648160","1812161840","84654340","2899120760"
"2021/10/26","235244990","143434310","1978905770","70419310","2428004380"
"2021/10/25","1049009840","163284320","2699579660","206518190","4118392010"
"2021/10/22","558241510","247390500","5765459040","121347720","6692438770"
"2021/10/21","956955800","251695850","4624779300","268694550","6102125500"
"2021/10/20","2079634060","457564920","7443034310","1034998670","11015231960"
"2021/10/19","3346343690","25756530","5484076170","764430450","9620606840"
"2021/10/18","946339780","3940260","2842460670","925887800","4718628510"
"2021/10/15","239709760","27318800","3266986940","277160930","3811176430"
"2021/10/14","4818344880","484343090","5686404970","553304050","11542396990"
"2021/10/13","789786000","75452700","4421750110","745261380","6032250190"
"2021/10/12","879451270","1232000","3442621130","1071107900","5394412300"
"2021/10/08","56713780","131625610","4222132250","862849760","5273321400"
"2021/10/07","92884560","542771000","2952903850","130067390","3718626800"
"2021/10/06","185567470","41411490","4101188690","762019700","5090187350"
"2021/10/05","278467660","61149440","6333484530","706820740","7379922370"
"2021/10/01","309924370","92814500","6347635330","92525090","6842899290"
"2021/09/30","297641470","5417880","4254190660","41994720","4599244730"
"2021/09/29","744777260","336416240","6744800840","89837220","7915831560"
"2021/09/28","291039670","35272040","11060773110","240534050","11627618870"
"2021/09/27","527201950","58725560","19253417190","672012200","20511356900"
"2021/09/24","104976040","5944920","6070240710","825871770","7007033440"
"2021/09/23","132842210","26075380","7402750780","819681850","8381350220"
"2021/09/17","818293930","357465080","16430525390","496222550","18102506950"
"2021/09/16","718282970","151398700","16042282330","803288450","17715252450"
"2021/09/15","948052400","317461900","55709566080","2797576880","59772657260"
"2021/09/14","51937734500","7460599540","414024825360","10586905130","484010064530"