일자,기관 합계,기타법인,개인,외국인 합계,전체
"2023/05/04","156917780","67636160","196403490","41380080","462337510"
"2023/05/03","331164480","44159290","172021910","26125580","573471260"
"2023/05/02","276148510","5823150","134990460","228226610","645188730"
"2023/04/28","380125520","7079320","622103740","97898790","1107207370"
"2023/04/27","181482810","492970","171959710","296919560","650855050"
"2023/04/26","383637440","24175520","514969360","68674680","991457000"
"2023/04/25","862203290","5710000","1365765390","166971730","2400650410"
"2023/04/24","373071630","11040870","196369600","345163320","925645420"
"2023/04/21","359166130","5600000","327245530","151905670","843917330"
"2023/04/20","352451300","20732200","427390560","112182860","912756920"
"2023/04/19","374037410","112260860","537549330","730757630","1754605230"
"2023/04/18","1058291250","27087200","734217950","282292350","2101888750"
"2023/04/17","1740142800","3936800","1037575950","478434500","3260090050"
"2023/04/14","882891880","0","511167780","763775250","2157834910"
"2023/04/13","510564690","5206120","356770910","642972900","1515514620"
"2023/04/12","671383220","5440","298612950","423256840","1393258450"
"2023/04/11","1704950270","0","171540030","344670660","2221160960"
"2023/04/10","1690941870","9489000","420835270","447153980","2568420120"
"2023/04/07","1158029090","0","318147870","424772710","1900949670"
"2023/04/06","1144033590","0","382735720","412072570","1938841880"
"2023/04/05","283173690","5520","192914810","345049530","821143550"
"2023/04/04","208175850","0","96271290","173597880","478045020"
"2023/04/03","282252540","5540","328523690","326542480","937324250"
"2023/03/31","224493050","1104000","135555110","205889060","567041220"
"2023/03/30","691123380","0","362194970","492949120","1546267470"
"2023/03/29","477255220","5695650","346716440","26286650","855953960"
"2023/03/28","416447580","20324000","200580020","80420510","717772110"
"2023/03/27","506846400","2845660","284504120","74421480","868617660"
"2023/03/24","354983770","2710980","270085670","218929260","846709680"
"2023/03/23","385526880","2678940","242317670","19769420","650292910"
"2023/03/22","615836820","2278560","133246620","63588640","814950640"
"2023/03/21","165310410","0","102057220","15383200","282750830"
"2023/03/20","387263310","1244080","147048270","396990900","932546560"
"2023/03/17","337247700","3789730","135911180","835783420","1312732030"
"2023/03/16","362446620","1286380","177201770","21427910","562362680"
"2023/03/15","470005020","1953490","225717190","2424650","700100350"
"2023/03/14","133433730","7773450","328469430","4313520","473990130"
"2023/03/13","97266570","85481810","117658750","17558680","317965810"
"2023/03/10","163452190","3250000","243587150","42170040","452459380"
"2023/03/09","55362620","0","146262160","0","201624780"
"2023/03/08","181544640","0","437649080","6421350","625615070"
"2023/03/07","420597800","37966270","237036560","67679800","763280430"
"2023/03/06","277085380","44434970","186629780","96981580","605131710"
"2023/03/03","399080190","125494720","755713890","179727300","1460016100"
"2023/03/02","189586690","0","227762670","52325160","469674520"
"2023/02/28","118358930","3802450","154076020","36321990","312559390"
"2023/02/27","154472910","14161420","57099070","73080370","298813770"
"2023/02/24","377276380","6600","47042970","97795330","522121280"
"2023/02/23","324189110","6610","268938930","60179510","653314160"
"2023/02/22","300369080","0","57799090","26802710","384970880"
"2023/02/21","288388210","1336000","62515190","40659550","392898950"
"2023/02/20","265095330","2678820","88755970","58399330","414929450"
"2023/02/17","205823000","6710","70689830","8260680","284780220"
"2023/02/16","290280140","0","215742830","93899920","599922890"
"2023/02/15","72267310","0","269174450","66738590","408180350"
"2023/02/14","154572600","0","139075890","48270680","341919170"
"2023/02/13","391972630","6825000","220052890","36669770","655520290"
"2023/02/10","181778070","0","124264160","33797410","339839640"
"2023/02/09","256488150","11946400","232518360","85143710","586096620"
"2023/02/08","270970020","0","131625740","43112730","445708490"
"2023/02/07","294385180","20853080","69910200","88162920","473311380"
"2023/02/06","129581400","5110000","53471590","212172780","400335770"
"2023/02/03","649539170","63940","153113260","167767270","970483640"
"2023/02/02","320467790","8697440","114678420","79954140","523797790"
"2023/02/01","308339640","0","178245210","50506880","537091730"
"2023/01/31","284859140","85157240","66439120","90749260","527204760"
"2023/01/30","382332840","2333620","142245310","65481480","592393250"
"2023/01/27","236925880","3596540","143207160","146694350","530423930"
"2023/01/26","193660520","4480930","234533080","99018810","531693340"
"2023/01/25","315925860","4787980","129676650","44171480","494561970"
"2023/01/20","241216020","4999760","223626390","36102600","505944770"
"2023/01/19","352409860","0","32011680","113036310","497457850"
"2023/01/18","278764560","0","140727150","85705340","505197050"
"2023/01/17","140871590","20900","47969360","97817810","286679660"
"2023/01/16","249532880","4350740","192868430","41478770","488230820"
"2023/01/13","170034500","13850","48566420","25646550","244261320"
"2023/01/12","118195490","13860","62761680","22006250","202977280"
"2023/01/11","90804350","3475000","46408250","72657870","213345470"
"2023/01/10","166512670","6972440","263397090","49430350","486312550"
"2023/01/09","156441070","6950","196166590","135476920","488091530"
"2023/01/06","142527610","5342190","134173440","89195750","371238990"
"2023/01/05","447434020","1702890","431299830","52114790","932551530"
"2023/01/04","101557950","1411388230","237797720","50251800","1800995700"
"2023/01/03","147658820","329310","323429420","97719530","569137080"
"2023/01/02","289661320","641370","279412830","64189140","633904660"
"2022/12/29","33985190","0","101013420","37211120","172209730"
"2022/12/28","42292150","0","174245270","18243630","234781050"
"2022/12/27","115510510","4781500","102975250","65104000","288371260"
"2022/12/26","37868940","0","267988880","9331590","315189410"
"2022/12/23","254121960","0","109995320","23723370","387840650"
"2022/12/22","494526440","39210","130756040","14013580","639335270"
"2022/12/21","206193840","52280","86935490","11537590","304719200"
"2022/12/20","239844150","5387610","115789210","15877660","376898630"
"2022/12/19","244250090","7788720","123702960","33294390","409036160"
"2022/12/16","308882800","6726370","236042940","21775280","573427390"
"2022/12/15","337202620","1322590","93535410","21672570","453733190"
"2022/12/14","360840010","7936100","72269570","23947700","464993380"
"2022/12/13","124248260","5880380","105069490","15452990","250651120"
"2022/12/12","120969930","4895570","78361150","11099610","215326260"
"2022/12/09","441528070","6725100","81213960","40117500","569584630"
"2022/12/08","154632050","0","107192270","19782360","281606680"
"2022/12/07","46056960","52260000","88099240","23280590","209696790"
"2022/12/06","131197540","0","199081520","29767310","360046370"
"2022/12/05","201191160","0","163743540","43777000","408711700"
"2022/12/02","177004030","0","129987630","59327650","366319310"
"2022/12/01","226171000","6860","58647050","55334430","340159340"
"2022/11/30","130490680","6165000","92143790","9401990","238201460"
"2022/11/29","54184760","0","67948320","80775030","202908110"
"2022/11/28","439022080","6850000","158944000","53546410","658362490"
"2022/11/25","125895520","0","87607850","57988410","271491780"
"2022/11/24","235118030","6920","113130560","87022500","435278010"
"2022/11/23","173965360","0","181017480","216160320","571143160"
"2022/11/22","110768220","0","103734690","71345990","285848900"
"2022/11/21","106368560","41540","105246020","50537150","262193270"
"2022/11/18","132006910","6960","108888550","44897080","285799500"
"2022/11/17","68289530","6950","104202840","118600430","291099750"
"2022/11/16","181603290","33310840","101429480","219010290","535353900"
"2022/11/15","158559090","7020000","92523000","243373790","501475880"
"2022/11/14","56826920","14200","154366060","158163940","369371120"
"2022/11/11","245818250","769630","328068310","337208190","911864380"
"2022/11/10","341810540","7056780","181539730","51742340","582149390"
"2022/11/09","255493690","0","124860280","17495760","397849730"
"2022/11/08","239851010","6790","80842510","16885540","337585850"
"2022/11/07","465435130","16245370","186340020","75246360","743266880"
"2022/11/04","199498630","14960700","272237580","88409900","575106810"
"2022/11/03","272944290","7255600","277790930","80621430","638612250"
"2022/11/02","1372111270","12844000","473326830","298644130","2156926230"
"2022/11/01","336126410","4149130","279411720","192456020","812143280"
"2022/10/31","607502510","160473510","451990800","184720790","1404687610"
"2022/10/28","190417940","58101510","112433140","39963010","400915600"
"2022/10/27","140663110","12457080","135300690","83245300","371666180"
"2022/10/26","217614710","23259000","157922950","86057870","484854530"
"2022/10/25","48771120","3800100","131585490","29842400","213999110"
"2022/10/24","62023510","3229160","162927240","51508210","279688120"
"2022/10/21","132266390","46766660","296366930","198289970","673689950"
"2022/10/20","801231110","143406480","483923200","230932340","1659493130"
"2022/10/19","953186730","7223360","242982020","230958610","1434350720"
"2022/10/18","1112386150","3892440","342439840","168741590","1627460020"
"2022/10/17","767179660","13200000","514270280","164414070","1459064010"
"2022/10/14","278072120","0","256214840","154918080","689205040"
"2022/10/13","630773840","15598380","701289290","187380220","1535041730"
"2022/10/12","231145670","1614240","299631700","82925090","615316700"
"2022/10/11","245732790","0","471811370","106326280","823870440"
"2022/10/07","273651290","0","214089510","96671950","584412750"
"2022/10/06","113408840","11235000","293831120","9995570","428470530"
"2022/10/05","399276670","54096900","768180450","40769670","1262323690"
"2022/10/04","69005000","17095850","312049650","80733010","478883510"
"2022/09/30","397653960","106284530","816901180","164119620","1484959290"
"2022/09/29","163536780","20579000","370179010","167362570","721657360"
"2022/09/28","333301390","0","495781730","171388110","1000471230"
"2022/09/27","125268550","23822700","530934990","123864510","803890750"
"2022/09/26","221889380","16155390","1121988890","183633920","1543667580"
"2022/09/23","155310100","5680700","380786280","73461100","615238180"
"2022/09/22","440793450","4010430","95108750","39933580","579846210"
"2022/09/21","189596120","774020","128226060","89444530","408040730"
"2022/09/20","33050420","958620","116145990","66033550","216188580"
"2022/09/19","374721530","0","198966330","442801180","1016489040"
"2022/09/16","400804390","17570010","546468000","11111365730","12076208130"
"2022/09/15","100851420","63900","561295000","486598900","1148809220"
"2022/09/14","273813130","1602000","744427290","556925640","1576768060"
"2022/09/13","153378580","69645960","323102290","892137260","1438264090"
"2022/09/08","64845980","15940","171785440","346372260","583019620"
"2022/09/07","200590700","15900","295331690","183650990","679589280"
"2022/09/06","232368690","0","226324890","103560960","562254540"
"2022/09/05","42268130","0","121824800","75784330","239877260"
"2022/09/02","84322180","7950","95712760","134049310","314092200"
"2022/09/01","290806800","8007740","122938010","310632720","732385270"
"2022/08/31","87628000","8030000","484908160","111100940","691667100"
"2022/08/30","211871690","110400","237319340","145212540","594513970"
"2022/08/29","175182440","0","237709500","246393670","659285610"
"2022/08/26","285306530","0","226554960","117936260","629797750"
"2022/08/25","312151600","315600","283277160","203339720","799084080"
"2022/08/24","15137310","2221300","144154020","547658510","709171140"
"2022/08/23","189748180","0","232499530","501952830","924200540"
"2022/08/22","15015820","15760","369347870","651695660","1036075110"
"2022/08/19","612864070","12001350","813917260","131970200","1570752880"
"2022/08/18","720087390","7851160","546712930","274013960","1548665440"
"2022/08/17","341215110","7800000","260710450","671872710","1281598270"
"2022/08/16","406896880","0","227301810","1101766970","1735965660"
"2022/08/12","142672750","15530","1285436660","74952550","1503077490"
"2022/08/11","53451530","53034320","196600390","4764950","307851190"
"2022/08/10","29059330","0","148245510","5209410","182514250"
"2022/08/09","141354810","0","190741480","30449570","362545860"
"2022/08/08","306587670","15147970","175610130","291272890","788618660"
"2022/08/05","237213180","7901390","178665990","157440630","581221190"
"2022/08/04","217931900","0","261857640","381350320","861139860"
"2022/08/03","209557160","86260","343506700","92287090","645437210"
"2022/08/02","191761460","0","396104630","239633300","827499390"
"2022/08/01","213721690","0","168255590","117130130","499107410"
"2022/07/29","402387750","19525260","152088330","187615640","761616980"
"2022/07/28","416707110","0","69134540","205968240","691809890"
"2022/07/27","404044420","38710","116723260","162685840","683492230"
"2022/07/26","304952770","272000","74976930","47883550","428085250"
"2022/07/25","393533060","7849000","122727660","304542220","828651940"
"2022/07/22","672562570","2337000","291800540","328572740","1295272850"
"2022/07/21","631196010","37872950","672234880","268035320","1609339160"
"2022/07/20","861810190","778000","461421840","346928730","1670938760"
"2022/07/19","343584260","155020","170149910","242946290","756835480"
"2022/07/18","622578190","15480000","204623820","114749270","957431280"
"2022/07/15","341491540","7720000","258900100","24177570","632289210"
"2022/07/14","71160900","7720000","73880930","17230920","169992750"
"2022/07/13","247799040","7800000","195639990","115942120","567181150"
"2022/07/12","174200710","0","243757110","17656690","435614510"
"2022/07/11","266063410","6185100","190233750","17694820","480177080"
"2022/07/08","157018890","28414500","136878850","23329440","345641680"
"2022/07/07","138331810","7780","142780340","6726810","287846740"
"2022/07/06","346066090","30940","188238840","35923110","570258980"
"2022/07/05","400019600","1603100","450376820","45705730","897705250"
"2022/07/04","138216270","0","473128970","61221390","672566630"
"2022/07/01","158486940","762000","306122830","24392730","489764500"
"2022/06/30","277680360","15300","341388900","29879970","648964530"
"2022/06/29","201070950","7680","107384520","20080400","328543550"
"2022/06/28","333520540","77107700","585884270","48544130","1045056640"
"2022/06/27","685221510","0","392699350","63919100","1141839960"
"2022/06/24","431632570","302899480","493156090","96395250","1324083390"
"2022/06/23","866468380","0","1461573370","148739500","2476781250"
"2022/06/22","296092670","77320000","568554350","58292560","1000259580"
"2022/06/21","793230790","45700","365500050","99738600","1258515140"
"2022/06/20","657720870","38600","926284830","149091140","1733135440"
"2022/06/17","188926290","0","827936510","374014400","1390877200"
"2022/06/16","170320810",,"163768460","190946570","525035840"
"2022/06/15","237985330","0","191835790","270201380","700022500"
"2022/06/14","285137380","15680","315559100","202344000","803056160"
"2022/06/13","267594910","34944810","393725820","111358530","807624070"
"2022/06/10","175015730","33546080","134096360","65741760","408399930"
"2022/06/09","119275330","36272660","92093500","78834880","326476370"
"2022/06/08","171584810","9600000","254301790","81977910","517464510"
"2022/06/07","442114680","112208020","322890640","248392330","1125605670"
"2022/06/03","459410900","22400000","516550640","103770180","1102131720"
"2022/06/02","397386680","15930","659424130","329589280","1386416020"
"2022/05/31","802330540","0","195290630","324386320","1322007490"
"2022/05/30","494719000","0","382756020","71550420","949025440"
"2022/05/27","352393420","10347390","438610750","131982230","933333790"
"2022/05/26","915138610","67340000","777837390","16645140","1776961140"
"2022/05/25","1144191840","7907910","575301200","112767180","1840168130"
"2022/05/24","496161400","58785000","590515040","41719700","1187181140"
"2022/05/23","415763330","7790","169086680","37683530","622541330"
"2022/05/20","1806495990","250400","701826650","76040080","2584613120"
"2022/05/19","412010250","0","347993340","458326640","1218330230"
"2022/05/18","354907450","15949230","330079650","268524170","969460500"
"2022/05/17","663329720","0","585975830","498641180","1747946730"
"2022/05/16","541044790","71841310","207882380","168539030","989307510"
"2022/05/13","507264060","77110","248168510","1262497370","2018007050"
"2022/05/12","250875880","49815100","381673580","399220710","1081585270"
"2022/05/11","412513890","69260","292494750","465512740","1170590640"
"2022/05/10","262629860","7767440","987871830","326432910","1584702040"
"2022/05/09","341167250","0","280764390","427262650","1049194290"
"2022/05/06","341436430","12534230","519679820","268931530","1142582010"
"2022/05/04","715680440","15650","225416790","64925500","1006038380"
"2022/05/03","921354110","7930000","809339330","252979060","1991602500"
"2022/05/02","1055910210","23890","841903580","52157110","1949994790"
"2022/04/29","1388304500","20802520","868358500","27869380","2305334900"
"2022/04/28","840762590","290772010","1543600450","347532660","3022667710"
"2022/04/27","672514380","24621070","964752160","85795240","1747682850"
"2022/04/26","6767074768","115902470","1709488980","174001190","8766467408"
"2022/04/25","328411460","198261160","552429960","31639380","1110741960"
"2022/04/22","366695850","179830000","285878650","88408940","920813440"
"2022/04/21","333699720","75052500","527201430","132927190","1068880840"
"2022/04/20","786313290","26811600","538549830","66460410","1418135130"
"2022/04/19","519495760","1581000","163017910","100371260","784465930"
"2022/04/18","437026490","72210","450651890","136535840","1024286430"
"2022/04/15","1225239950","72704950","703958200","155977460","2157880560"
"2022/04/14","557951290","7140000","491645130","92561510","1149297930"
"2022/04/13","589277940","156580630","535309560","127127120","1408295250"
"2022/04/12","359752010","53749810","777024180","61019920","1251545920"
"2022/04/11","616533580","35838830","213893700","61277660","927543770"
"2022/04/08","264269200","60434630","479628850","97159030","901491710"
"2022/04/07","205761950","3886460","670323270","90022590","969994270"
"2022/04/06","618337880","317402380","1542488630","122712590","2600941480"
"2022/04/05","717994960","141093840","1872468580","38450740","2770008120"
"2022/04/04","2358044220","10472090","568005820","1151384500","4087906630"
"2022/04/01","1681672380","0","390444990","12208320","2084325690"
"2022/03/31","3164110220","0","102264170","127988160","3394362550"
"2022/03/30","3182794230","7700000","454385730","351087900","3995967860"
"2022/03/29","549729340","62560","481127770","38047820","1068967490"
"2022/03/28","485502030","21473720","314072530","26403380","847451660"
"2022/03/25","1413689240","66130000","511613140","22712250","2014144630"
"2022/03/24","264878420","0","571719970","67595800","904194190"
"2022/03/23","881584320","0","159567400","93715670","1134867390"
"2022/03/22","504307500","0","405011840","28080560","937399900"
"2022/03/21","154703440","0","220310810","77972290","452986540"
"2022/03/18","396064120","0","70863330","84829050","551756500"
"2022/03/17","177395930","97171780","83223090","203911990","561702790"
"2022/03/16","147855700","9928440","82191350","34921330","274896820"
"2022/03/15","278717740","0","406437820","69451400","754606960"
"2022/03/14","204960890","7790","319394310","7166800","531529790"
"2022/03/11","266372370","0","210322010","188877870","665572250"
"2022/03/10","345171180","1630300","916189460","161990320","1424981260"
"2022/03/08","291080860","0","533436490","61838850","886356200"
"2022/03/07","137953950","58218710","355160830","203050760","754384250"
"2022/03/04","131810390","6368000","176585240","78484680","393248310"
"2022/03/03","1240433690","0","147685770","102388510","1490507970"
"2022/03/02","787658720","0","330034100","54887890","1172580710"
"2022/02/28","1132616400","3212000","214475670","17761390","1368065460"
"2022/02/25","157361360","3512560","85572930","106118220","352565070"
"2022/02/24","273354890","8014000","214083210","216836750","712288850"
"2022/02/23","32135250","55007100","105976140","60724130","253842620"
"2022/02/22","1977003960","0","364371720","198250910","2539626590"
"2022/02/21","104854340","0","100336980","20181350","225372670"
"2022/02/18","254592570","0","362604260","37934650","655131480"
"2022/02/17","320269110","0","389369610","354667850","1064306570"
"2022/02/16","144721180","477956560","163403080","214248980","1000329800"
"2022/02/15","212799670","0","148808030","11109570","372717270"
"2022/02/14","45684200","0","225103810","18503110","289291120"
"2022/02/11","462477840","155646360","161464770","141512400","921101370"
"2022/02/10","428487200","8998320","231576520","6969230","676031270"
"2022/02/09","339981750","0","150674480","15524250","506180480"
"2022/02/08","267399970","33588420","223950430","43609270","568548090"
"2022/02/07","175816010","48624800","85964350","28292690","338697850"
"2022/02/04","138067770","0","358528830","16640870","513237470"
"2022/02/03","287609020","0","427356490","51649060","766614570"
"2022/01/28","153669700","12000000","253666390","195040080","614376170"
"2022/01/27","430967560","32284750","1239053630","148132000","1850437940"
"2022/01/26","263369570","0","65105120","81091840","409566530"
"2022/01/25","319259110","8047920","369424420","191585930","888317380"
"2022/01/24","59042640","124598210","271365040","77951200","532957090"
"2022/01/21","126408800","806000","246004010","4383820","377602630"
"2022/01/20","127212890","805000","146566170","14310790","288894850"
"2022/01/19","79347810","0","284404360","72132700","435884870"
"2022/01/18","52866580","1608000","248849510","39874100","343198190"
"2022/01/17","24849250","2381940","275354040","6363730","308948960"
"2022/01/14","99917770","25637000","244340230","10530380","380425380"
"2022/01/13","124076200","0","181500380","22729490","328306070"
"2022/01/12","20669620","802000","178604640","40243620","240319880"
"2022/01/11","152551100","4807000","209572290","42173770","409104160"
"2022/01/10","339380590","76936000","278683810","12063440","707063840"
"2022/01/07","110512010","12015000","108689730","30347000","261563740"
"2022/01/06","219389480","0","211641190","36101680","467132350"
"2022/01/05","191547880","7980","174861220","19300210","385717290"
"2022/01/04","281792670","0","214393390","352849650","849035710"
"2022/01/03","199213010","8010","222857510","110996410","533074940"
"2021/12/30","144085630",,"152833780","222556410","519475820"
"2021/12/29","191619280","55880","194134300","225065870","610875330"
"2021/12/28","874445940","0","234908310","66259580","1175613830"
"2021/12/27","94912360","24102060","162187190","2196750","283398360"
"2021/12/24","405981580","48542140","69653060","37717520","561894300"
"2021/12/23","313090750","0","226686210","15117520","554894480"
"2021/12/22","89699660","0","239323920","0","329023580"
"2021/12/21","362819350","0","212811880","95065750","670696980"
"2021/12/20","348416530","0","317279100","134516080","800211710"
"2021/12/17","299875070","0","322699530","37729710","660304310"
"2021/12/16","27037750","0","106235330","24227780","157500860"
"2021/12/15","14033840","7970","122044110","18810490","154896410"
"2021/12/14","91327250",,"111420660","46764780","249512690"
"2021/12/13","22307860","239100","155736940","35889270","214173170"
"2021/12/10","26573030","79800000","308154980","173635220","588163230"
"2021/12/09","362479710","0","196747580","29938000","589165290"
"2021/12/08","36202270","15880000","79303550","155832940","287218760"
"2021/12/07","89248660","0","139318980","253523310","482090950"
"2021/12/06","40325650","0","68230150","249556150","358111950"
"2021/12/03","78955740","0","95956290","154021570","328933600"
"2021/12/02","147270170","0","82786190","125608540","355664900"
"2021/12/01","265038700","0","387967600","116697280","769703580"
"2021/11/30","238176350","39720","199041710","302145080","739402860"
"2021/11/29","153946630","19272000","196009910","129508170","498736710"
"2021/11/26","288983850","30191850","90543120","37905380","447624200"
"2021/11/25","334843790","0","75105590","43708840","453658220"
"2021/11/24","200874530","22091580","236163420","16748030","475877560"
"2021/11/23","379945610",,"114299600","16376960","510622170"
"2021/11/22","138339190","0","148910540","23392170","310641900"
"2021/11/19","70937090",,"137578670","8174340","216690100"
"2021/11/18","97111540","19136050","175314020","29011850","320573460"
"2021/11/17","124796670",,"105586520","55709960","286093150"
"2021/11/16","211646730","8020","75931420","4015660","291601830"
"2021/11/15","214683070","0","206631530","7845130","429159730"
"2021/11/12","135252000","0","94603360","27998860","257854220"
"2021/11/11","119065040","1648000","299383400","34854160","454950600"
"2021/11/10","202977140","1600000","140879530","98402020","443858690"
"2021/11/09","137069070","0","201828790","76877970","415775830"
"2021/11/08","53887420","0","213948830","21634580","289470830"
"2021/11/05","252444900","0","525967080","127288780","905700760"
"2021/11/04","219786290","0","98907200","121570870","440264360"
"2021/11/03","326486800","0","189764570","133373270","649624640"
"2021/11/02","396497590","0","327472440","210640820","934610850"
"2021/11/01","447077170","0","300860360","473774890","1221712420"
"2021/10/29","54747240","0","426215450","111994180","592956870"
"2021/10/28","107675050","0","233436990","65641760","406753800"
"2021/10/27","268315040","0","424463450","19488160","712266650"
"2021/10/26","331474320","3155370","139604720","34887830","509122240"
"2021/10/25","153565110","12160200","240036160","21781440","427542910"
"2021/10/22","14691800","90160000","202732530","21074480","328658810"
"2021/10/21","77100960","0","163958490","40325160","281384610"
"2021/10/20","171724040","0","321667390","29210450","522601880"
"2021/10/19","159339030","11286000","419187640","207392150","797204820"
"2021/10/18","114501560","53188770","175032320","35784450","378507100"
"2021/10/15","203367870","107532440","134142450","341747420","786790180"
"2021/10/14","56610940","110573000","551987910","156195910","875367760"
"2021/10/13","13378190","294242180","292679140","67236910","667536420"
"2021/10/12","162922940","3228000","341570380","323956660","831677980"
"2021/10/08","56699660","45983140","253776920","107286470","463746190"
"2021/10/07","369779380",,"339811830","150024700","859615910"
"2021/10/06","1905902840","0","298385920","503860560","2708149320"
"2021/10/05","130745170","9588720","490992050","278891330","910217270"
"2021/10/01","197404140","2197800","549886790","84725180","834213910"
"2021/09/30","122740420","30337500","200763850","107407910","461249680"
"2021/09/29","371254400","40853410","681661120","255492810","1349261740"
"2021/09/28","547130030","23839000","441477610","43585360","1056032000"
"2021/09/27","449597480","53209380","788123970","132635620","1423566450"
"2021/09/24","184016410","0","442780360","157593710","784390480"
"2021/09/23","91364120","19050400","432660500","196473070","739548090"
"2021/09/17","104711430","8210000","253057840","165153230","531132500"
"2021/09/16","64835690","70444000","113962320","53207680","302449690"
"2021/09/15","4673210","14332500","242024510","6626390","267656610"
"2021/09/14","197124860","12330000","177589030","37735740","424779630"
"2021/09/13","279736070","0","213983710","36066810","529786590"
"2021/09/10","61191570","0","102463050","4128320","167782940"
"2021/09/09","325170530","24570000","121012180","25954490","496707200"
"2021/09/08","135093840","0","312947210","46207040","494248090"
"2021/09/07","199103170","3863400","339655010","8194520","550816100"
"2021/09/06","113268500","1600950","248605130","56710760","420185340"
"2021/09/03","273291210","4092110","371905560","535375460","1184664340"
"2021/09/02","111109720","0","365369660","18513890","494993270"
"2021/09/01","680325730","105726880","159372390","40016760","985441760"
"2021/08/31","357262670","16285000","618547350","17515900","1009610920"
"2021/08/30","90160740","0","177469960","60160320","327791020"
"2021/08/27","175539600","8080","197118670","13128190","385794540"
"2021/08/26","117316470","0","271488910","28565940","417371320"
"2021/08/25","124017580","16659490","142115770","18940670","301733510"
"2021/08/24","102749600",,"176570460","59335770","338655830"
"2021/08/23","94709180","46699640","157677310","6291720","305377850"
"2021/08/20","381918140","21460480","402041150","102983600","908403370"
"2021/08/19","152099680","79166590","512453960","36702940","780423170"
"2021/08/18","463990760","27990420","532203220","8971550","1033155950"
"2021/08/17","227667530","13039320","511033470","74616840","826357160"
"2021/08/13","334129050","0","445465020","43272070","822866140"
"2021/08/12","387165400","355520","279625380","18507880","685654180"
"2021/08/11","209808460","21378200","292882680","32745910","556815250"
"2021/08/10","261031470","89020220","104096650","40202800","494351140"
"2021/08/09","63687500","3954300","189226540","52579510","309447850"
"2021/08/06","218383190","10410300","402623960","48766500","680183950"
"2021/08/05","103628400",,"143988630","29987930","277604960"
"2021/08/04","551395780","0","446189600","60743830","1058329210"
"2021/08/03","84026930","696080","284442390","110769610","479935010"
"2021/08/02","201823280","0","188390570","101413190","491627040"
"2021/07/30","215362270","0","215798990","96897230","528058490"
"2021/07/29","111068720","1988580","540385790","140336280","793779370"
"2021/07/28","101246130","21646360","112194430","99032490","334119410"
"2021/07/27","228087810","15780000","115915190","202379480","562162480"
"2021/07/26","127602450","0","136611550","190314190","454528190"
"2021/07/23","217842030","0","133562040","197659030","549063100"
"2021/07/22","89968770","0","96206740","208147700","394323210"
"2021/07/21","1564762470","0","98258710","119620740","1782641920"
"2021/07/20","617129700","8030000","362858850","132763480","1120782030"
"2021/07/19","821635150","0","150559000","109489060","1081683210"
"2021/07/16","182192720","315550260","95702480","147993430","741438890"
"2021/07/15","796274470","547373810","225376370","39809730","1608834380"
"2021/07/14","386505930","156879310","105590660","96757620","745733520"
"2021/07/13","767471780","0","156076470","36308130","959856380"
"2021/07/12","365559300","0","197861490","13176430","576597220"
"2021/07/09","228628980","499840","790022760","75517310","1094668890"
"2021/07/08","502912250","23858280","530980010","117954490","1175705030"
"2021/07/07","510267040","0","308815830","156662990","975745860"
"2021/07/06","650225550","0","230518340","70855650","951599540"
"2021/07/05","523560810","0","583565050","112918100","1220043960"
"2021/07/02","403018030","0","133550200","114272200","650840430"
"2021/07/01","442842270","161963680","128314250","165946240","899066440"
"2021/06/30","260361130","40754660","268008120","69415930","638539840"
"2021/06/29","175586320","853650","211248510","113542590","501231070"
"2021/06/28","294369220","0","178782450","87578420","560730090"
"2021/06/25","373741090","0","355974740","61054640","790770470"
"2021/06/24","244842900","73081750","262648800","48902440","629475890"
"2021/06/23","313989550","87039040","133772440","182733930","717534960"
"2021/06/22","85579480","0","154657640","110446760","350683880"
"2021/06/21","538439850","0","522103150","178890430","1239433430"
"2021/06/18","387502240",,"312988360","87501190","787991790"
"2021/06/17","333412500","88470220","126276470","93682710","641841900"
"2021/06/16","578858620","0","248750080","169386760","996995460"
"2021/06/15","1002994630","0","358891020","60408070","1422293720"
"2021/06/14","1077694680","42570280","393635470","87859720","1601760150"
"2021/06/11","1088175840","1406140","695274030","141961050","1926817060"
"2021/06/10","294239990","0","223602020","117927550","635769560"
"2021/06/09","941485630","135360","346299820","136916590","1424837400"
"2021/06/08","453475530","0","389953120","64567850","907996500"
"2021/06/07","459884930","2577000","457084410","203188570","1122734910"
"2021/06/04","560806860","0","420389190","232784790","1213980840"
"2021/06/03","614428120","0","347514090","274360070","1236302280"
"2021/06/02","1753935610","16124920","572430930","132521420","2475012880"
"2021/06/01","674058790","25051620","602780210","159926940","1461817560"
"2021/05/31","252848890","849000","520273150","89547580","863518620"
"2021/05/28","298056390","13394000","581878200","60895650","954224240"
"2021/05/27","407550360","8244740","558258860","22127080","996181040"
"2021/05/26","257037780","0","162561100","31883180","451482060"
"2021/05/25","442942050","82400","345613840","11818450","800456740"
"2021/05/24","147675630","13136000","281339610","29174420","471325660"
"2021/05/21","272418940","0","456721760","14868940","744009640"
"2021/05/20","246517140","0","169424640","63141680","479083460"
"2021/05/18","355103650","820000","229140830","18420690","603485170"
"2021/05/17","295892710","163600","310003000","104322630","710381940"
"2021/05/14","214313420","47218500","384269710","43610570","689412200"
"2021/05/13","391101780","39853440","615839820","74945500","1121740540"
"2021/05/12","240171840","6264230","438575710","403219980","1088231760"
"2021/05/11","713655870","99440340","371108710","66410660","1250615580"
"2021/05/10","724220450","64747200","713162500","47596800","1549726950"
"2021/05/07","283766660",,"411611420","31944420","727322500"
"2021/05/06","529020470",,"353923420","77596190","960540080"
"2021/05/04","1414799600","48902590","548799180","133510260","2146011630"
"2021/05/03","382577280","0","507614010","92867350","983058640"
"2021/04/30","494914750","62015820","643749250","40675270","1241355090"
"2021/04/29","473861040","12289400","774945620","60310180","1321406240"
"2021/04/28","328296710","91649010","791602710","144795230","1356343660"
"2021/04/27","581398050","48805050","1068288810","104195590","1802687500"
"2021/04/26","700450210","95248330","479108950","117734890","1392542380"
"2021/04/23","862678940","15782000","645556230","80403800","1604420970"
"2021/04/22","710047370","1564000","862523180","214716420","1788850970"
"2021/04/21","318946150","30040980","389735990","74692230","813415350"
"2021/04/20","404270920","15380000","503457610","54012620","977121150"
"2021/04/19","333425620","0","328736430","47375790","709537840"
"2021/04/16","201506330","4278800","262384610","9131340","477301080"
"2021/04/15","68897750",,"277157780","80316890","426372420"
"2021/04/14","132133220",,"322637550","67311090","522081860"
"2021/04/13","237104000","42682350","559357810","54136620","893280780"
"2021/04/12","210014650","1093610","301915980","7155680","520179920"
"2021/04/09","497374150","40859320","338178040","10997130","887408640"
"2021/04/08","130999700","37302000","646327500","20217530","834846730"
"2021/04/07","382872060","37320000","149815540","5886290","575893890"
"2021/04/06","250385240","37027000","763445670","29409750","1080267660"
"2021/04/05","323206680","0","275164220","190196570","788567470"
"2021/04/02","330828280","16657760","524946010","141209800","1013641850"
"2021/04/01","159373320","66435480","545463920","32463450","803736170"
"2021/03/31","211617730","0","547445270","90290180","849353180"
"2021/03/30","206561900","66691130","947063500","245720170","1466036700"
"2021/03/29","262891420","132337820","1684392430","381858240","2461479910"
"2021/03/26","206061520","612133300","1840404010","163907750","2822506580"
"2021/03/25","547485070","44884410","936845250","26739940","1555954670"
"2021/03/24","190859660","49274050","478023440","72115700","790272850"
"2021/03/23","244590210","89170000","339218290","27032170","700010670"
"2021/03/22","138110800","117524840","406758390","16924290","679318320"
"2021/03/19","574254270","53136400","201781760","58671960","887844390"
"2021/03/18","201138010","181082000","245939190","554120","628713320"
"2021/03/17","137767980","119120150","303498800","16141140","576528070"
"2021/03/16","469887570","138044300","170669800","63365450","841967120"
"2021/03/15","134905410","0","306603800","22066050","463575260"
"2021/03/12","125958070","0","216278690","46692930","388929690"
"2021/03/11","7495880880","0","283247940","55465870","7834594690"
"2021/03/10","141098200","2187000","179094130","41024650","363403980"
"2021/03/09","27364190","0","287338060","86208470","400910720"
"2021/03/08","268144580","0","451665180","8700050","728509810"
"2021/03/05","291870120","0","354560180","47214980","693645280"
"2021/03/04","138532920","0","197034210","29604300","365171430"
"2021/03/03","90440120","14460000","124426960","51273080","280600160"
"2021/03/02","103363530","0","363718550","115610160","582692240"
"2021/02/26","121511940","0","494237980","50356890","666106810"
"2021/02/25","219160430","12270680","284148190","71886570","587465870"
"2021/02/24","346827910","3525000","341992570","70161840","762507320"
"2021/02/23","336660110","16807920","356777250","16613020","726858300"
"2021/02/22","287172890","3560000","142918160","3852360","437503410"
"2021/02/19","390245600","2112000","182456360","58656260","633470220"
"2021/02/18","418089550","17540660","149734340","16253230","601617780"
"2021/02/17","590858090","7090000","269525080","62765290","930238460"
"2021/02/16","43341750","0","341486200","12561160","397389110"
"2021/02/15","345611120","139191000","647511960","140458290","1272772370"
"2021/02/10","23826440","172684130","297346470","47325450","541182490"
"2021/02/09","55086560","285631910","237387520","60723260","638829250"
"2021/02/08","104900950","101139780","374645840","24970150","605656720"
"2021/02/05","90581680","15065100","249776550","1157260","356580590"
"2021/02/04","209562530","0","105908460","12022110","327493100"
"2021/02/03","145499260","7050","329869560","50306100","525681970"
"2021/02/02","187273480","110918400","357719950","41699380","697611210"
"2021/02/01","138800960","0","293052090","51042990","482896040"
"2021/01/29","169154450","69470360","555013310","11700090","805338210"
"2021/01/28","71237520","15444000","326618350","53703070","467002940"
"2021/01/27","111502440","0","480103530","3623590","595229560"
"2021/01/26","31568630","0","270973870","9167360","311709860"
"2021/01/25","263442810","69987090","415783780","180708610","929922290"
"2021/01/22","147893800","0","413631550","27515140","589040490"
"2021/01/21","206644680","0","220642050","18967760","446254490"
"2021/01/20","135665140","0","337243650","39527490","512436280"
"2021/01/19","499412150","0","225881540","24188500","749482190"
"2021/01/18","623433910","0","381992020","38090550","1043516480"
"2021/01/15","219228130","0","339738320","33658210","592624660"
"2021/01/14","279961170","5259700","249558480","63486770","598266120"
"2021/01/13","164057150","0","500737950","32333090","697128190"
"2021/01/12","317237110","350500","367059340","13410460","698057410"
"2021/01/11","265157530","0","1229461580","38828620","1533447730"
"2021/01/08","140844150","0","394689960","54739770","590273880"
"2021/01/07","52484910","18455580","479304870","34169580","584414940"
"2021/01/06","250565950","93858000","507420160","35793910","887638020"
"2021/01/05","268038240","0","653734820","70450580","992223640"
"2021/01/04","54791820","64373080","706731730","19695350","845591980"
"2020/12/30","97256430","57305100","308047250","56942590","519551370"
"2020/12/29","108167300","161526610","374134600","34316490","678145000"
"2020/12/28","112565260","89706100","334396930","58850780","595519070"
"2020/12/24","186766380","168023210","243268880","13232570","611291040"
"2020/12/23","168174180","1981400","196846760","69592090","436594430"
"2020/12/22","60092040","0","112324460","60067610","232484110"
"2020/12/21","237277770","0","201033890","53848470","492160130"
"2020/12/18","48860850","804560","302394410","26493340","378553160"
"2020/12/17","104527870","7069390","711013650","62206970","884817880"
"2020/12/16","84840650","0","209631060","22109750","316581460"
"2020/12/15","402936100","0","620060950","21455040","1044452090"
"2020/12/14","457093030","0","423729420","82648570","963471020"
"2020/12/11","879281210","2470440","380977880","37934060","1300663590"
"2020/12/10","275627510","888480","412955790","12517540","701989320"
"2020/12/09","244863150","173375350","265052360","28480500","711771360"
"2020/12/08","77997240",,"330648940","3027060","411673240"
"2020/12/07","409765090","1078500","570329110","26638830","1007811530"
"2020/12/04","162173300","2956000","240390240","5297100","410816640"
"2020/12/03","165368470","665100","214883850","54410550","435327970"
"2020/12/02","42890440","11092380","223714460","36988770","314686050"
"2020/12/01","118626930","0","238452920","54489790","411569640"
"2020/11/30","282980950","0","453635350","36287700","772904000"
"2020/11/27","202031570","27965460","168162410","11619650","409779090"
"2020/11/26","81437510",,"225444200","27417440","334299150"
"2020/11/25","64751530",,"194182560","33155990","292090080"
"2020/11/24","321103180","6624000","364453180","57019830","749200190"
"2020/11/23","101859290","0","387505720","12981060","502346070"
"2020/11/20","85883040",,"628415180","143515130","857813350"
"2020/11/19","5886970","0","437986670","77814170","521687810"
"2020/11/18","30950760",,"384971430","25909150","441831340"
"2020/11/17","94737490","7200000","208042680","8398190","318378360"
"2020/11/16","128333630",,"303210520","2681580","434225730"
"2020/11/13","101011060","7841640","246650520","8850240","364353460"
"2020/11/12","49033320","0","111409880","7522960","167966160"
"2020/11/11","104515110","17236680","263772280","96948640","482472710"
"2020/11/10","207258330","0","324985430","37204810","569448570"
"2020/11/09","145812470",,"261597510","41288150","448698130"
"2020/11/06","75151870","0","191295120","56019460","322466450"
"2020/11/05","171487910",,"370114510","52209540","593811960"
"2020/11/04","68343080",,"252091430","53623270","374057780"
"2020/11/03","189156990","0","256223090","9581780","454961860"
"2020/11/02","472910000",,"210948130","66630840","750488970"
"2020/10/30","183843660","19666290","806807490","76868480","1087185920"
"2020/10/29","253522750","0","276569600","54031820","584124170"
"2020/10/28","159674730","35500","159525270","91167240","410402740"
"2020/10/27","142507110",,"616740080","177614980","936862170"
"2020/10/26","324842400","2716670","291261500","150613290","769433860"
"2020/10/23","567102270","21500000","452233140","74304410","1115139820"
"2020/10/22","471634410","2832000","392442180","107694750","974603340"
"2020/10/21","315320330","40327060","379661470","54746120","790054980"
"2020/10/20","145807290","2233450","470208860","92784310","711033910"
"2020/10/19","30904310","0","708084530","10055280","749044120"
"2020/10/16","472412050","0","215553480","48563080","736528610"
"2020/10/15","301726010","0","395583640","34716860","732026510"
"2020/10/14","232684320","0","237327250","62147690","532159260"
"2020/10/13","145026390","0","348355130","69377470","562758990"
"2020/10/12","18927270","33900000","156190020","95737320","304754610"
"2020/10/08","169181780","33950000","337701180","20791570","561624530"
"2020/10/07","365709840","0","293557600","109783860","769051300"
"2020/10/06","57910150","0","199853220","81856590","339619960"
"2020/10/05","46922990","0","444641520","60195020","551759530"
"2020/09/29","17188030","6075000","699039890","5078510","727381430"
"2020/09/28","21551700","0","751442650","91968620","864962970"
"2020/09/25","132157790",,"761997320","136584090","1030739200"
"2020/09/24","204552250","27884790","433248180","104363840","770049060"
"2020/09/23","284712790","6790000","234342620","44365790","570211200"
"2020/09/22","185985520","6770000","186368690","69980940","449105150"
"2020/09/21","122594320","0","220704820","118153100","461452240"
"2020/09/18","110674430","1362000","290921110","79799860","482757400"
"2020/09/17","88349950","0","159805870","40280820","288436640"
"2020/09/16","182848430","35613150","228838540","27914800","475214920"
"2020/09/15","335859910","0","321076880","38575210","695512000"
"2020/09/14","334897860","0","378769290","22745080","736412230"
"2020/09/11","193886110","0","221051630","65432760","480370500"
"2020/09/10","357049790","0","223978920","20002580","601031290"
"2020/09/09","70698160","0","537684490","107599530","715982180"
"2020/09/08","502511170","762230","592482810","28400680","1124156890"
"2020/09/07","140356040","0","360647920","21897490","522901450"
"2020/09/04","83067650","0","507864290","30960620","621892560"
"2020/09/03","43603190","6610000","372950240","1363250","424526680"
"2020/09/02","12921230","0","270890780","6600","283818610"
"2020/09/01","165183520","0","209800650","6854370","381838540"
"2020/08/31","175144960","0","422044480","67861430","665050870"
"2020/08/28","17877660","0","302255570","41094940","361228170"
"2020/08/27","35633830","0","376355790","55995490","467985110"
"2020/08/26","137364970","0","190127950","12774310","340267230"
"2020/08/25","224487350","0","432710080","26903560","684100990"
"2020/08/24","62024270","0","365126310","47476630","474627210"
"2020/08/21","89871220","12981040","391907310","25187980","519947550"
"2020/08/20","98325910","5850000","478179680","61934670","644290260"
"2020/08/19","153039200","0","434465400","20881900","608386500"
"2020/08/18","529758510","0","504657450","285872990","1320288950"
"2020/08/14","190262010","17541270","343502640","70822870","622128790"
"2020/08/13","266970550","3320000","295760390","234939860","800990800"
"2020/08/12","253980250","11663800","956767390","34223420","1256634860"
"2020/08/11","185531280","0","826565370","42144670","1054241320"
"2020/08/10","185515600","0","475981800","43262510","704759910"
"2020/08/07","146610280","0","743883170","67487170","957980620"
"2020/08/06","64816400","0","366140460","29386110","460342970"
"2020/08/05","253325290","0","536415840","20048920","809790050"
"2020/08/04","337035450","0","375904580","17615560","730555590"
"2020/08/03","198173150","0","343661560","4146720","545981430"
"2020/07/31","252805350","0","198849100","3646090","455300540"
"2020/07/30","20115300","481740","349846760","23020600","393464400"
"2020/07/29","239862250","4767660","213217050","23533430","481380390"
"2020/07/28","133479840","86657000","271169970","50352750","541659560"
"2020/07/27","515494410","0","455229690","114769090","1085493190"
"2020/07/24","90354460","0","563824750","45575450","699754660"
"2020/07/23","66088270","0","376741230","61813320","504642820"
"2020/07/22","32024910","0","430255520","51230190","513510620"
"2020/07/21","45670460",,"570347000","90189810","706207270"
"2020/07/20","111210390","0","884813370","98683720","1094707480"
"2020/07/17","49617310","26421250","377388700","92200650","545627910"
"2020/07/16","103071430","0","407685420","62274040","573030890"
"2020/07/15","82088240","0","270921820","120234810","473244870"
"2020/07/14","6604220","0","179415440","99263120","285282780"
"2020/07/13","153967370","0","429677790","256982900","840628060"
"2020/07/10","73687490","0","236340390","217285780","527313660"
"2020/07/09","95689400","0","302062500","141300690","539052590"
"2020/07/08","613149620","131918430","209464720","304467610","1259000380"
"2020/07/07","198015370","0","184648420","289540630","672204420"
"2020/07/06","50480650","0","578475860","358001120","986957630"
"2020/07/03","88176840","0","187737790","313578840","589493470"
"2020/07/02","10692790","6457150","225134490","209376130","451660560"
"2020/07/01","56107980","0","155008210","213438410","424554600"
"2020/06/30","67116680","0","205813960","462797830","735728470"
"2020/06/29","5347620","0","323423690","340108650","668879960"
"2020/06/26","145059400","1350000","275338720","154187130","575935250"
"2020/06/25","121989450","0","334441020","227833550","684264020"
"2020/06/24","137470520","0","218738190","68930120","425138830"
"2020/06/23","246796720","0","258267120","109717540","614781380"
"2020/06/22","233209940","0","174982870","149920140","558112950"
"2020/06/19","132338890","0","245722730","145844970","523906590"
"2020/06/18","105786060","480960","416584890","49760930","572612840"
"2020/06/17","192951890","6198330","308620340","166135410","673905970"
"2020/06/16","282692550","47250","234294090","137451170","654485060"
"2020/06/15","421416800","47670","518683840","173430830","1113579140"
"2020/06/12","613626020","5404140","499420990","143506960","1261958110"
"2020/06/11","361240200","825860","677481110","297794740","1337341910"
"2020/06/10","501075400","41580","451766710","269319890","1222203580"
"2020/06/09","728953920","160388580","434996300","211899970","1536238770"
"2020/06/08","422564980","360600970","276203990","60847180","1120217120"
"2020/06/05","1227154240","451571120","691033330","124876210","2494634900"
"2020/06/04","457437970","492752900","371246940","26062850","1347500660"
"2020/06/03","722022680","139322360","438390250","45307130","1345042420"
"2020/06/02","629887570","22459000","268437100","12354690","933138360"
"2020/06/01","293809560","0","397980940","31747670","723538170"
"2020/05/29","229504800","1048500","281782760","40067990","552404050"
"2020/05/28","459494200","0","524048460","301774540","1285317200"
"2020/05/27","419893210","1844200","301554600","335246940","1058538950"
"2020/05/26","655187560","161120","747125160","299520080","1701993920"
"2020/05/25","166370380","2612550","614236780","264438940","1047658650"
"2020/05/22","759708720","8803010","1102596410","414088790","2285196930"
"2020/05/21","683553400","6770000","1637662210","435321720","2763307330"
"2020/05/20","370694510","3260000","578344030","180257120","1132555660"
"2020/05/19","320159520","12532320","1179808800","198638020","1711138660"
"2020/05/18","316973950","11705690","468586170","89894360","887160170"
"2020/05/15","281308230","1403460","180641170","172498680","635851540"
"2020/05/14","851339850","13474000","125512750","593679020","1584005620"
"2020/05/13","397768930","1250000","230040300","291256880","920316110"
"2020/05/12","456351810","13819960","159318520","246167090","875657380"
"2020/05/11","329496050","990600","289985940","78236150","698708740"
"2020/05/08","632544030","2215500","211595720","587897350","1434252600"
"2020/05/07","374780980","1908000","399527350","407555790","1183772120"
"2020/05/06","103967930","2250500","90461050","322749600","519429080"
"2020/05/04","142913960","1920000","56468080","340460150","541762190"
"2020/04/29","150753480","1668780","418998460","94889140","666309860"
"2020/04/28","265973770","0","157627010","130803490","554404270"
"2020/04/27","266434990","0","83760200","86959930","437155120"
"2020/04/24","208390680","13208800","93451320","104306420","419357220"
"2020/04/23","312884850","12800000","323271110","78577600","727533560"
"2020/04/22","898533860","0","205942130","160239620","1264715610"
"2020/04/21","417787900","6480000","229771210","142790080","796829190"
"2020/04/20","354989140","0","155134570","50876580","561000290"
"2020/04/17","386726580","0","391091680","85608010","863426270"
"2020/04/16","407610","38328650","221310490","18403790","278450540"
"2020/04/14","335698210","0","225696260","56214510","617608980"
"2020/04/13","427178530","2257600","109661360","88707040","627804530"
"2020/04/10","214486050","1874270","329201150","80199270","625760740"
"2020/04/09","240511120","0","153016820","47696700","441224640"
"2020/04/08","424907150","0","600291160","68590220","1093788530"
"2020/04/07","379251590","1416000","267316560","84990280","732974430"
"2020/04/06","8913010","8688860","609734080","51765150","679101100"
"2020/04/03","37399710","13085260","521936450","41716060","614137480"
"2020/04/02","36352080","9927180","306981940","55254880","408516080"
"2020/04/01","427714960","22055540","641797450","316843550","1408411500"
"2020/03/31","75609390","3366930","404620020","276579200","760175540"
"2020/03/30","288092270","10686550","550393570","331738080","1180910470"
"2020/03/27","1073931000","481310","1329100420","155386910","2558899640"
"2020/03/26","640998860","129456380","706833560","238442450","1715731250"
"2020/03/25","523168240","61300000","1094640710","208356080","1887465030"
"2020/03/24","407200510","3100140","770626560","70333440","1251260650"
"2020/03/23","305749520","0","829799980","87533640","1223083140"
"2020/03/20","991504400","0","693248490","221538000","1906290890"
"2020/03/19","438475380","137952960","1491684000","254221570","2322333910"
"2020/03/18","501225500","27280000","710257090","116080100","1354842690"
"2020/03/17","190488450","302958840","746845510","215693620","1455986420"
"2020/03/16","597145820","103591490","581573300","197448910","1479759520"
"2020/03/13","1059219430","335927890","1702900010","280434000","3378481330"
"2020/03/12","466843780","3334440","959645180","279902970","1709726370"
"2020/03/11","528222950","0","447370580","172216530","1147810060"
"2020/03/10","50176850","0","537033290","242078390","829288530"
"2020/03/09","195215840","10027400","795257490","351992810","1352493540"
"2020/03/06","199021170","0","544605400","89039880","832666450"
"2020/03/05","1557964170","5976000","649926120","58492950","2272359240"
"2020/03/04","831073010","849606910","452060120","178454660","2311194700"
"2020/03/03","103143320","69676810","182802660","72149010","427771800"
"2020/03/02","241903220","10480000","773215380","160799320","1186397920"
"2020/02/28","447587170","19642500","885555210","271900350","1624685230"
"2020/02/27","57176370","0","159313860","73820500","290310730"
"2020/02/26","247503170","0","304523960","195771090","747798220"
"2020/02/25","101994100","0","564771850","161641560","828407510"
"2020/02/24","132872120","0","670926740","259644370","1063443230"
"2020/02/21","32095420","72357820","297875110","31221480","433549830"
"2020/02/20","79747300","72870420","317105220","37244910","506967850"
"2020/02/19","600596630","74612510","308736120","45636010","1029581270"
"2020/02/18","340318810","73791040","184953130","38851900","637914880"
"2020/02/17","322109790","147698920","375293320","76354500","921456530"
"2020/02/14","688336450","221756560","217237970","108858500","1236189480"
"2020/02/13","350337100","0","194192970","46388720","590918790"
"2020/02/12","612218130","0","226465190","95833800","934517120"
"2020/02/11","555421680","933600","335976580","55778370","948110230"
"2020/02/10","25350700","0","255891330","57104230","338346260"
"2020/02/07","6777180","0","130508560","33404370","170690110"
"2020/02/06","17262480","0","289391020","78192450","384845950"
"2020/02/05","541982930","0","288325210","72674900","902983040"
"2020/02/04","85032330","0","332759860","96087810","513880000"
"2020/02/03","169311080","22560000","824613190","137669770","1154154040"
"2020/01/31","195440570","0","403927740","83698260","683066570"
"2020/01/30","56276230","18228760","387644300","79615810","541765100"
"2020/01/29","9042050","0","352282110","157268710","518592870"
"2020/01/28","25484700","3044280","575253940","148977450","752760370"
"2020/01/23","4223600","84849850","223863950","169760960","482698360"
"2020/01/22","52694750","0","227625100","94567900","374887750"
"2020/01/21","103849990","12885000","980363470","123447980","1220546440"
"2020/01/20","31433010","74455000","194749890","189126770","489764670"
"2020/01/17","110135770","3512230","223009760","135591650","472249410"
"2020/01/16","173033310","6103960","729006560","133804160","1041947990"
"2020/01/15","105749270","59752500","570470510","60188290","796160570"
"2020/01/14","112124460","1292320","1300201890","178510710","1592129380"
"2020/01/13","458487850","95829900","636558030","248069030","1438944810"
"2020/01/10","5728140","0","293682570","139315070","438725780"
"2020/01/09","79626200","26690000","293068860","135839950","535225010"
"2020/01/08","13899510","7620360","342790250","290882630","655192750"
"2020/01/07","55081070","0","138577510","385039130","578697710"
"2020/01/06","74401910","0","400858380","190951880","666212170"
"2020/01/03","130897360","17786760","672077170","679489370","1500250660"
"2020/01/02","319722580","1964000","846249360","320263570","1488199510"
"2019/12/30","279125190",,"256738550","215112370","750976110"
"2019/12/27","311736920","0","459291820","231597920","1002626660"
"2019/12/26","104361730","51341560","632076230","269794230","1057573750"
"2019/12/24","50814520","6267540","361296300","211794540","630172900"
"2019/12/23","180490","0","443725630","140672120","584578240"
"2019/12/20","85026540","4959410","532554500","218904480","841444930"
"2019/12/19","73593140","10426130","786776530","289085770","1159881570"
"2019/12/18","59251930","13878000","449393340","268165440","790688710"
"2019/12/17","16638850","0","645213010","629788080","1291639940"
"2019/12/16","1774316120","3889000","1139288610","284837300","3202331030"
"2019/12/13","2230174660","0","847934940","270302800","3348412400"
"2019/12/12","2151780260","2085250","606168460","106105650","2866139620"
"2019/12/11","1663252810","8880400","1137452100","102779790","2912365100"
"2019/12/10","1837154630","0","624803410","107534440","2569492480"
"2019/12/09","793692040","301424250","931944700","129858160","2156919150"
"2019/12/06","397266980","6432300","362977230","149920510","916597020"
"2019/12/05","216912760","41858570","484497490","179339890","922608710"
"2019/12/04","336914230","3156960","566489810","116378340","1022939340"
"2019/12/03","675136620","24038000","1073993650","261927460","2035095730"
"2019/12/02","175442900","50766580","197713620","245419300","669342400"
"2019/11/29","16521120","79564740","703117170","212647090","1011850120"
"2019/11/28","37281650","51833510","537743470","88125890","714984520"
"2019/11/27","59801230","50518160","177152160","266943270","554414820"
"2019/11/26","382360240","89313190","290133610","352981270","1114788310"
"2019/11/25","2023560","52603670","579998530","274256990","908882750"
"2019/11/22","143326800","2502000","276694030","381291940","803814770"
"2019/11/21","117831710","0","791916040","627222030","1536969780"
"2019/11/20","290153100","0","762128510","486487130","1538768740"
"2019/11/19","418360680","0","1216410780","630495650","2265267110"
"2019/11/18","2149616000","143471440","3686369270","85960780","6065417490"
"2019/11/15","1124946420","0","1389866730","187673100","2702486250"
"2019/11/14","2128418260","0","1748655730","382074780","4259148770"
"2019/11/13","1005505400","0","1271913550","290106050","2567525000"
"2019/11/12","23902170","3881370","558672930","346935350","933391820"
"2019/11/11","916502820","0","1301268300","268481470","2486252590"
"2019/11/08","971638980","26716840","2305432050","1418928480","4722716350"
"2019/11/07","28570270","89096000","2532082190","93195250","2742943710"
"2019/11/06","370716230","6822500","2470902830","126749700","2975191260"
"2019/11/05","989560280","125681830","1198507050","220933850","2534683010"
"2019/11/04","126305730","20142500","1610539400","126435660","1883423290"
"2019/11/01","4305210680","1720000","556292720","177949900","5041173300"
"2019/10/31","134147610","10953000","1454500840","21794400","1621395850"
"2019/10/30","415668860","36945340","1843458520","66475530","2362548250"
"2019/10/29","480884250","2522350","497660280","262165130","1243232010"
"2019/10/28","542986520","8307810","766712670","97488050","1415495050"
"2019/10/25","126005900","4542400","800286390","229075350","1159910040"
"2019/10/24","268202840","0","309173910","374255360","951632110"
"2019/10/23","15985100","1108800","841890490","370091340","1229075730"
"2019/10/22","6997870","23943130","979295020","489495930","1499731950"
"2019/10/21","622013620","38978000","1292280470","191330380","2144602470"
"2019/10/18","628124370","13778000","1280747680","24583580","1947233630"
"2019/10/17","652787550","470960","985889100","7602180","1646749790"
"2019/10/16","349133380","3682500","876446300","171994160","1401256340"
"2019/10/15","368967460","39208000","1364714650","17050990","1789941100"
"2019/10/14","14856300","39903000","500582020","109104990","664446310"
"2019/10/11","0","39880000","517074450","120337460","677291910"
"2019/10/10","109116010","0","503233680","56108760","668458450"
"2019/10/08","28042630","0","635718850","78886850","742648330"
"2019/10/07","1953550","0","675811100","208198690","885963340"
"2019/10/04","41115990","0","729727510","145346900","916190400"
"2019/10/02","104096080","223637600","530168510","27630990","885533180"
"2019/10/01","255694850","0","257269640","83840980","596805470"
"2019/09/30","92114530","79900000","682230490","79642210","933887230"
"2019/09/27","479127380","0","291020720","114463940","884612040"
"2019/09/26","88758040","43224000","578931190","74701800","785615030"
"2019/09/25","243920090","142340650","503872640","85457660","975591040"
"2019/09/24","247582020","233496000","314928310","39037440","835043770"
"2019/09/23","116973060","136474300","491934600","77534350","822916310"
"2019/09/20","279916640","81247280","656972290","122205420","1140341630"
"2019/09/19","201152350","52332540","682094900","92067400","1027647190"
"2019/09/18","175454540","51548570","231078140","40375340","498456590"
"2019/09/17","101899460","51614300","423470640","108768870","685753270"
"2019/09/16","234532130","0","615241290","117318560","967091980"
"2019/09/11","148953430","0","972997880","80543070","1202494380"
"2019/09/10","291375450","6939760","1353358780","19531970","1671205960"
"2019/09/09","238279000","104548590","910893050","64391290","1318111930"
"2019/09/06","107090030","0","429875250","43552200","580517480"
"2019/09/05","729487070","0","1032946470","163075510","1925509050"
"2019/09/04","455384440","24694500","1200986960","105815190","1786881090"
"2019/09/03","257355110","16330440","1473493680","38194970","1785374200"
"2019/09/02","269955610","11700000","1330793650","92429430","1704878690"
"2019/08/30","203132470","5310000","570232370","73642510","852317350"
"2019/08/29","149300","141930","132195220","56432370","188918820"
"2019/08/28","185366340","3750000","459547050","42444170","691107560"
"2019/08/27","92606980","453230","262127450","81706540","436894200"
"2019/08/26","136628380","0","374350590","62886060","573865030"
"2019/08/23","60387640","11808000","347907860","79314410","499417910"
"2019/08/22","135326250","70015000","726895650","72971830","1005208730"
"2019/08/21","94741530","52084440","300491400","57113280","504430650"
"2019/08/20","107711320","0","323574150","8225660","439511130"
"2019/08/19","40103890","0","445032560","69423940","554560390"
"2019/08/16","77365510","0","337845030","48014760","463225300"
"2019/08/14","58722080","0","360756010","70369050","489847140"
"2019/08/13","112609550","1727880","221666740","54432060","390436230"
"2019/08/12","108997140","0","225446160","40585290","375028590"
"2019/08/09","6060610","0","405405110","103970480","515436200"
"2019/08/08","228849530","0","146456140","106668690","481974360"
"2019/08/07","445064790","40607240","581812680","86934870","1154419580"
"2019/08/06","671405230","118150","682136460","256659220","1610319060"
"2019/08/05","194478490","8201040","506110950","163392830","872183310"
"2019/08/02","52976110","14649610","378903300","29691880","476220900"
"2019/08/01","143078540","24569990","332018200","222726700","722393430"
"2019/07/31","225641610","23160070","494561480","145769270","889132430"
"2019/07/30","64640500","123163320","345498320","18931590","552233730"
"2019/07/29","172481650","0","405728260","150513390","728723300"
"2019/07/26","284440910","0","113063650","49045490","446550050"
"2019/07/25","181643200","0","361031560","80210480","622885240"
"2019/07/24","80023470","2178570","463562670","22299020","568063730"
"2019/07/23","125561820","0","233246730","52836390","411644940"
"2019/07/22","7169800","0","683611600","15342350","706123750"
"2019/07/19","17009270","6391000","688161290","6963060","718524620"
"2019/07/18","22821590","0","501330270","15287840","539439700"
"2019/07/17","74475920","4554280","587840740","67101610","733972550"
"2019/07/16","247987350","39867130","505456270","84930560","878241310"
"2019/07/15","261248490","15289540","1166706550","95924910","1539169490"
"2019/07/12","28010090","10545000","527397730","95767910","661720730"
"2019/07/11","25554930","7070000","445929000","189213070","667767000"
"2019/07/10","173437880","31705000","707475410","152306370","1064924660"
"2019/07/09","10673820","7020000","784177400","71518790","873390010"
"2019/07/08","193136410","32713950","446344360","15194700","687389420"
"2019/07/05","65396060","7130000","199982060","58395420","330903540"
"2019/07/04","83576000","8572000","437346390","72790800","602285190"
"2019/07/03","345170360","14237630","908237440","15687650","1283333080"
"2019/07/02","420755370","80694540","1050823700","42247840","1594521450"
"2019/07/01","5548000","293380","538628010","31749490","576218880"
"2019/06/28","20088030","0","388501920","27557740","436147690"
"2019/06/27","303160","27000","252847760","55337760","308515680"
"2019/06/26","260730650","0","399239010","39100770","699070430"
"2019/06/25","39367190","258770","550285790","87082160","676993910"
"2019/06/24","74095770","13420000","360944140","61700720","510160630"
"2019/06/21","78226240","27200","362709230","88857530","529820200"
"2019/06/20","35497000","10408520","790684280","41884910","878474710"
"2019/06/19","66692240","36675000","264300400","27063080","394730720"
"2019/06/18","79647580","6605000","712451420","125555070","924259070"
"2019/06/17","1608870","56018580","335549490","5412320","398589260"
"2019/06/14","70537320","108215780","88832120","69828720","337413940"
"2019/06/13","79229990","59912520","168133410","33633770","340909690"
"2019/06/12","98108330","69397220","193176940","28621360","389303850"
"2019/06/11","5040570","174629580","522656540","19477770","721804460"
"2019/06/10","447790","77565460","289211270","5520560","372745080"
"2019/06/07","11534250","30483200","165072830","33663140","240753420"
"2019/06/05","63244950","64798340","266641740","32713940","427398970"
"2019/06/04","20295380","32723200","231944770","46436150","331399500"
"2019/06/03","652855230","70500000","217045990","32449150","972850370"
"2019/05/31","107520670","120990320","484755050","35003660","748269700"
"2019/05/30","447300","134651120","332929960","31021470","499049850"
"2019/05/29","488350","147993100","284819260","6921020","440221730"
"2019/05/28","322442180","254350930","432212920","84090700","1093096730"
"2019/05/27","82815040","214998370","352475790","34714220","685003420"
"2019/05/24","15374180","102401870","730471470","18091320","866338840"
"2019/05/23","33222030","310173220","160533550","51174820","555103620"
"2019/05/22","578420","34152930","392921690","90238960","517892000"
"2019/05/21","16855630","208929000","533135130","43169640","802089400"
"2019/05/20","62133450","33965000","623680650","74577110","794356210"
"2019/05/17","63218020","72202500","637165810","2185220","774771550"
"2019/05/16","63400","78407220","269407690","15811870","363690180"
"2019/05/15","19070910","64494320","157560040","28347970","269473240"
"2019/05/14","31544870","0","326649820","85104930","443299620"
"2019/05/13","31540","151440","276524590","50214700","326922270"
"2019/05/10","1133820","42174840","262811770","77558710","383679140"
"2019/05/09","1551710","49283120","981841420","77632050","1110308300"
"2019/05/08","55139390","112880000","871201200","79496990","1118717580"
"2019/05/07","10577800","110663630","256258540","24086930","401586900"
"2019/05/03","12380","143495760","105436180","27272630","276216950"
"2019/05/02","31860110","248451320","156585110","35097350","471993890"
"2019/04/30","8383960","167927940","77972690","15957150","270241740"
"2019/04/29","296231130","156861370","175558490","7097030","635748020"
"2019/04/26","51187990","123392780","96742470","15215480","286538720"
"2019/04/25","189715260","140148100","478496300","72510680","880870340"
"2019/04/24","403722820","210253690","179964780","24007740","817949030"
"2019/04/23","8517480","15401550","456297070","13700830","493916930"
"2019/04/22","35810220","98551830","508095350","64034360","706491760"
"2019/04/19","97510","87183590","131043500","44526940","262851540"
"2019/04/18","12356210","29520470","436812680","24405120","503094480"
"2019/04/17","25275400","3055000","380023830","15973260","424327490"
"2019/04/16","514159250","0","348249520","44550560","906959330"
"2019/04/15","522792540","0","156853700","61233150","740879390"
"2019/04/12","517904910","61996530","318480640","213748360","1112130440"
"2019/04/11","192748710","743313020","1370301550","194063340","2500426620"
"2019/04/10","1029120","35243960","943040120","35490","979348690"
"2019/04/09","1793230","0","347034480","24623010","373450720"
"2019/04/08","12260230","0","461611890","15077730","488949850"
"2019/04/05","14408790","0","123987230","26773550","165169570"
"2019/04/04","235771320","0","523592410","96212790","855576520"
"2019/04/03","74338950","0","197667480","13749970","285756400"
"2019/04/02","111118640","0","257613700","512430","369244770"
"2019/04/01","98153250","288191540","578229560","63438160","1028012510"
"2019/03/29","119563160","209858190","189876230","37872780","557170360"
"2019/03/28","120966040","17026710","334765720","20295200","493053670"
"2019/03/27","0","229814320","560774300","44814200","835402820"
"2019/03/26","33549680","283695610","535053450","7454260","859753000"
"2019/03/25","546021890","0","256803420","62795280","865620590"
"2019/03/22","603951320","0","250220160","67724180","921895660"
"2019/03/21","386429920","0","302462960","19313320","708206200"
"2019/03/20","617316210","0","334830850","27520040","979667100"
"2019/03/19","112947810","8845000","277947830","92204490","491945130"
"2019/03/18","239469670","29122700","263219060","22288680","554100110"
"2019/03/15","3472600","0","280823740","10978080","295274420"
"2019/03/14","145209020","0","113940090","10845130","269994240"
"2019/03/13","207108470","0","206956860","23100490","437165820"
"2019/03/12","319561350","13831430","198006040","74598860","605997680"
"2019/03/11","63710430","196920770","416330030","28131660","705092890"
"2019/03/08","74640230","4257500","194749790","65008000","338655520"
"2019/03/07","119855110","0","81516380","17305910","218677400"
"2019/03/06","259041720","3328290","106073510","11242990","379686510"
"2019/03/05","169022430","5162580","88961140","24019490","287165640"
"2019/03/04","190249020","110883670","176914080","28128990","506175760"
"2019/02/28","39413170","11247800","66848990","16246730","133756690"
"2019/02/27","208251970","2825000","133159900","25459520","369696390"
"2019/02/26","69306150","21326980","166297520","16866780","273797430"
"2019/02/25","39750270","0","317652140","12474920","369877330"
"2019/02/22","128202690","7523760","252609590","7760930","396096970"
"2019/02/21","41174630","0","219588950","0","260763580"
"2019/02/20","178530510","0","136513690","25579450","340623650"
"2019/02/19","447585050","0","117598870","25075440","590259360"
"2019/02/18","75036810","0","152667320","30388520","258092650"
"2019/02/15","43892600","11674820","380394450","0","435961870"
"2019/02/14","49457570","0","100166950","17537170","167161690"
"2019/02/13","49290380","31209270","214995820","6168560","301664030"
"2019/02/12","65028300","57926160","204878750","43721510","371554720"
"2019/02/11","32799900","8490000","256215620","1851300","299356820"
"2019/02/08","27925620","0","101848920","11240","129785780"
"2019/02/07","28646890","39233580","79861230","17285720","165027420"
"2019/02/01","37560500","39752000","107486280","27212000","212010780"
"2019/01/31","55053730","329094050","267358440","567340","652073560"
"2019/01/30","154043950","560000","93124250","112962930","360691130"
"2019/01/29","48009810","284201950","1971560880","20345940","2324118580"
"2019/01/28","60962230","291637890","89166030","2811850","444578000"
"2019/01/25","95793400",,"180883000","35071080","311747480"
"2019/01/24","62916770",,"114616020","13938020","191470810"
"2019/01/23","42754790","0","387208600","48429230","478392620"
"2019/01/22","29211300",,"304277690","15864490","349353480"
"2019/01/21","28380280",,"218573930","25522490","272476700"
"2019/01/18","27401490",,"122796300","21935580","172133370"
"2019/01/17","51186880","0","155288450","44278120","250753450"
"2019/01/16","420021160","0","83613450","20086470","523721080"
"2019/01/15","315638170","0","226036100","26181780","567856050"
"2019/01/14","172945260","54000000","51660920","9943480","288549660"
"2019/01/11","246090600","146760460","83487920","42459470","518798450"
"2019/01/10","282111870","27050000","95521520","34754580","439437970"
"2019/01/09","186084660","0","139755340","10768210","336608210"
"2019/01/08","553981010","10880000","92592780","7744300","665198090"
"2019/01/07","332843450","0","368821860","8960550","710625860"
"2019/01/04","246406080","0","75075560","61390","321543030"
"2019/01/03","13303150","0","280593080","20004340","313900570"
"2019/01/02","32326830","0","114461530","2476340","149264700"