일자,기관 합계,기타법인,개인,외국인 합계,전체
"2023/05/04","17470790","3790","13892980","5032005","36399565"
"2023/05/03","31420380","0","25423025","4032845","60876250"
"2023/05/02","9373460","3760","30541360","2124385","42042965"
"2023/04/28","40971460","3765","35406345","2123735","78505305"
"2023/04/27","12611665","3770","9051220","4701595","26368250"
"2023/04/26","91977585","7530","22405235","3433665","117824015"
"2023/04/25","42238720","0","13205290","4080740","59524750"
"2023/04/24","29963810","0","44590050","4061540","78615400"
"2023/04/21","51419690","0","62814875","4750190","118984755"
"2023/04/20","35227715","14248440","9820270","29473100","88769525"
"2023/04/19","22194245","14258195","25234290","4995605","66682335"
"2023/04/18","64683930","0","8705665","3510530","76900125"
"2023/04/17","5994810","0","15339165","3677455","25011430"
"2023/04/14","23472255","12487700","6073810","5027455","47061220"
"2023/04/13","17619660","7675","2120495","4506320","24254150"
"2023/04/12","7356540","0","25662985","3191885","36211410"
"2023/04/11","22026095","7670","41981260","3848930","67863955"
"2023/04/10","4072955","3815","67788825","4506335","76371930"
"2023/04/07","41400","0","28013070","6076730","34131200"
"2023/04/06","955100","0","11695130","4014955","16665185"
"2023/04/05","9014610","3775","69852240","4367450","83238075"
"2023/04/04","15180","0","144239185","31764385","176018750"
"2023/04/03","3389950","0","42564150","2702620","48656720"
"2023/03/31","29087110","85521165","70059515","2740130","187407920"
"2023/03/30","1631030","0","28710975","654695","30996700"
"2023/03/29","0","209520","19751190","1435515","21396225"
"2023/03/28","828790","275125","16841470","2577860","20523245"
"2023/03/27","5105885","0","25621770","1999105","32726760"
"2023/03/24","8692700","0","8435870","2342905","19471475"
"2023/03/23","0","0","21817345","2698830","24516175"
"2023/03/22","2548250","1233225","29856680","1999145","35637300"
"2023/03/21","25622215","0","2148050","2781405","30551670"
"2023/03/20","6164495","83360","1495005","2333075","10075935"
"2023/03/17","4160800","423725","22142860","3380370","30107755"
"2023/03/16","223680","0","15646425","2611830","18481935"
"2023/03/15","2043440","398500","13621825","4072890","20136655"
"2023/03/14","7993790","3950","33203920","4636260","45837920"
"2023/03/13","14484925","0","12004090","4181970","30670985"
"2023/03/10","0","2385000","28700635","3807145","34892780"
"2023/03/09","1002500","0","9097400","1547410","11647310"
"2023/03/08","5482120","0","14724790","3988840","24195750"
"2023/03/07","22828300","17186550","41615455","4013950","85644255"
"2023/03/06","1810500","0","29074760","1858045","32743305"
"2023/03/03","38470680","4005","25812055","4564825","68851565"
"2023/03/02","5712775","0","16860635","1927595","24501005"
"2023/02/28","18534700","0","38793915","1903030","59231645"
"2023/02/27","21090600","0","12986930","3208855","37286385"
"2023/02/24","803890","769920","21039330","1229690","23842830"
"2023/02/23","22829185","0","23161910","1986465","47977560"
"2023/02/22","10608870","0","58581575","3164635","72355080"
"2023/02/21","11798235","0","18627090","3746660","34171985"
"2023/02/20","7179370","8060","39462155","3516895","50166480"
"2023/02/17","14924100","0","5638980","3023930","23587010"
"2023/02/16","14285150","0","18010565","2113985","34409700"
"2023/02/15","14180285","0","17652200","15511245","47343730"
"2023/02/14","17694210","8184180","36398150","4164830","66441370"
"2023/02/13","14265220","0","24158970","4013445","42437635"
"2023/02/10","6387680","0","24571045","478300","31437025"
"2023/02/09","3123690","0","94509035","87555","97720280"
"2023/02/08","21135050","0","76901720","186400","98223170"
"2023/02/07","28403270","0","3618735","1807125","33829130"
"2023/02/06","5390495","1243830","65743415","3283850","75661590"
"2023/02/03","32280405","82685","146810550","3353815","182527455"
"2023/02/02","790470","11391570","56097500","3286900","71566440"
"2023/02/01","1474200","0","53526295","7336120","62336615"
"2023/01/31","1950510","2050115","45337060","2346885","51684570"
"2023/01/30","2714920","2340410","27480095","9996540","42531965"
"2023/01/27","426870","2325200","49335590","12540","52100200"
"2023/01/26","21668050","7842580","60213150","981645","90705425"
"2023/01/25","2506670","7837500","60080250","2132695","72557115"
"2023/01/20","118218310","7776440","42922460","1518220","170435430"
"2023/01/19","3868545","0","23501400","1906780","29276725"
"2023/01/18","6114660","4165","55184715","91495","61395035"
"2023/01/17","5485425","8315","48189325","832100","54515165"
"2023/01/16","4120","7724750","47127680","8220","54864770"
"2023/01/13","10991685","8160","32105385","0","43105230"
"2023/01/12","9850485","0","47336240","199450","57386175"
"2023/01/11","8174750","0","13556805","8040","21739595"
"2023/01/10","8329310","8040","64314945","32195","72684490"
"2023/01/09","7653020","0","100822775","391330","108867125"
"2023/01/06","2509220","3975","88403910","191745","91108850"
"2023/01/05","27554810","3905","55806770","8474105","91839590"
"2023/01/04","10388385","7790","33384975","6053025","49834175"
"2023/01/03","7780","0","29733825","8442240","38183845"
"2023/01/02","469200","7830","37640395","14115025","52232450"
"2022/12/29","4634150","0","99877145","17625380","122136675"
"2022/12/28","4286660","0","133194295","19463535","156944490"
"2022/12/27","3855820","1215435","24659700","8191195","37922150"
"2022/12/26","32705","4090","45700575","5586590","51323960"
"2022/12/23","64764685","0","35434355","1165260","101364300"
"2022/12/22","6308650","16105","55776270","0","62101025"
"2022/12/21","22420560","12070","52864920","0","75297550"
"2022/12/20","10335490","40075","186798790","28834040","226008395"
"2022/12/19","70103255","3183895","184723810","63371920","321382880"
"2022/12/16","22236440","4020","32463270","13555815","68259545"
"2022/12/15","10174715","0","19386520","5737420","35298655"
"2022/12/14","18773550","0","28599205","718555","48091310"
"2022/12/13","7398610","0","27409785","20036550","54844945"
"2022/12/12","12334880","8100","37641710","5602375","55587065"
"2022/12/09","13487775","0","27490885","4055","40982715"
"2022/12/08","6460815","0","107501770","7390960","121353545"
"2022/12/07","5086140","0","56717770","18869920","80673830"
"2022/12/06","65271855","1763750","47998195","25068550","140102350"
"2022/12/05","14694110","3261895","36330800","1305970","55592775"
"2022/12/02","8054640","12689920","124903605","2390775","148038940"
"2022/12/01","43342495","20316570","296694560","8822340","369175965"
"2022/11/30","48281160","0","69194650","6633005","124108815"
"2022/11/29","72223170","0","110870455","1149110","184242735"
"2022/11/28","116573825","556500","72097850","8093710","197321885"
"2022/11/25","113837410","0","220255640","5164585","339257635"
"2022/11/24","17806260","0","24404875","3200720","45411855"
"2022/11/23","14450715","0","11267995","8132070","33850780"
"2022/11/22","62361465","0","37495265","5344785","105201515"
"2022/11/21","18138325","3995","97182275","15737625","131062220"
"2022/11/18","28805130","0","15899715","11292175","55997020"
"2022/11/17","40946810","0","40723240","7117255","88787305"
"2022/11/16","87085315","0","69884920","10726630","167696865"
"2022/11/15","19636380","0","40068470","30995905","90700755"
"2022/11/14","80491790","7921870","69021620","3450890","160886170"
"2022/11/11","121081550","19581425","157664980","12382465","310710420"
"2022/11/10","53338520","11410","11859085","31270380","96479395"
"2022/11/09","74656780","3830","39466600","1462355","115589565"
"2022/11/08","58889200","11245","29748095","6174280","94822820"
"2022/11/07","82044465","7450","11229490","13853245","107134650"
"2022/11/04","45181050","128005","43455610","46197665","134962330"
"2022/11/03","48559005","7595","7821975","8971585","65360160"
"2022/11/02","27337290","7680","25506705","8109665","60961340"
"2022/11/01","81805745","15285","19745165","10027085","111593280"
"2022/10/31","110182110","1497760","77394350","12320250","201394470"
"2022/10/28","54764910","2271295","63097690","50058425","170192320"
"2022/10/27","234424395","3772275","48787455","13475495","300459620"
"2022/10/26","271363245","0","47748865","72619430","391731540"
"2022/10/25","84735235","0","31876395","29253095","145864725"
"2022/10/24","234078865","0","28388115","28811280","291278260"
"2022/10/21","80427335","0","90759280","45811150","216997765"
"2022/10/20","331383815","0","65539610","75409125","472332550"
"2022/10/19","115940215","0","70194360","37164135","223298710"
"2022/10/18","112132285","11520025","189657825","16627645","329937780"
"2022/10/17","45699955","97625","126592190","17520920","189910690"
"2022/10/14","92551955","200000","68953365","2564815","164270135"
"2022/10/13","79732930","0","79227415","16391835","175352180"
"2022/10/12","54131585","1864560","26299145","10186710","92482000"
"2022/10/11","122492975","0","260385990","18984535","401863500"
"2022/10/07","30791225","0","69077855","14774360","114643440"
"2022/10/06","61352955","1068780","95213235","17625160","175260130"
"2022/10/05","91534195","0","197010105","27056060","315600360"
"2022/10/04","32195210","88807710","152806490","3432020","277241430"
"2022/09/30","25515475","4255","82997500","7645220","116162450"
"2022/09/29","24829020","4285","46929895","19730125","91493325"
"2022/09/28","168748030","0","25698195","37771615","232217840"
"2022/09/27","85439915","0","153520390","14349545","253309850"
"2022/09/26","69978850","30780","206983840","17715745","294709215"
"2022/09/23","33292005","0","72141870","12386500","117820375"
"2022/09/22","58311520","40345","27889040","10362200","96603105"
"2022/09/21","23878075","4500","9366005","3635100","36883680"
"2022/09/20","37018770","4480","31584600","4658955","73266805"
"2022/09/19","78128465","0","20231565","8061625","106421655"
"2022/09/16","22560935","0","48588805","8613835","79763575"
"2022/09/15","61616535","0","16179675","3328950","81125160"
"2022/09/14","96864490","0","14301760","3417570","114583820"
"2022/09/13","71159300","59571425","73153375","4176540","208060640"
"2022/09/08","57092645","0","30849700","7694750","95637095"
"2022/09/07","69127315","0","9825395","18704825","97657535"
"2022/09/06","32922100","0","9625910","4617990","47166000"
"2022/09/05","50893365","0","17800455","7345275","76039095"
"2022/09/02","53958270","4600","72133170","10566050","136662090"
"2022/09/01","67995050","0","21982865","30187625","120165540"
"2022/08/31","13349290","0","68012315","3604350","84965955"
"2022/08/30","89515085","18655","30774730","32040650","152349120"
"2022/08/29","36427465","0","96823085","20508025","153758575"
"2022/08/26","13480035","9470","79063165","26019970","118572640"
"2022/08/25","23406775","0","136527845","7353485","167288105"
"2022/08/24","13952415","32320","104821160","6518825","125324720"
"2022/08/23","4106620","0","153714475","21557000","179378095"
"2022/08/22","417061895","4560","63063905","16779105","496909465"
"2022/08/19","46714200","11607140","100501725","28047495","186870560"
"2022/08/18","259157265","0","51672660","31625165","342455090"
"2022/08/17","61494660","3785570","85566585","22569895","173416710"
"2022/08/16","37581705","4720","17048230","12698375","67333030"
"2022/08/12","91820265","4690","33612145","3577970","129015070"
"2022/08/11","6301470","9330","17535325","3815750","27661875"
"2022/08/10","18060425","142214210","40911975","37791145","238977755"
"2022/08/09","56281465","15549060","27643605","13210270","112684400"
"2022/08/08","39049770","4710","137683450","14849965","191587895"
"2022/08/05","51109765","4670","102449480","27252400","180816315"
"2022/08/04","92244950","146638420","220820130","74301970","534005470"
"2022/08/03","140297305","113824110","172918495","39675130","466715040"
"2022/08/02","54745280","44622030","170885940","63604135","333857385"
"2022/08/01","53781865","6309975","50108260","36488295","146688395"
"2022/07/29","41564270","332860","107224405","123425070","272546605"
"2022/07/28","69538605","4442775","387825565","13261190","475068135"
"2022/07/27","252377560","0","94513505","47968730","394859795"
"2022/07/26","121421450","13140","115033980","47796725","284265295"
"2022/07/25","141161800",,"267434870","6638445","415235115"
"2022/07/22","356355935","7589105","124165835","47926970","536037845"
"2022/07/21","147214600","3991410","184697660","43095765","378999435"
"2022/07/20","94622395","0","64129505","11552590","170304490"
"2022/07/19","128313255","4670","95302480","41190680","264811085"
"2022/07/18","60150280","7102500","866790","19587485","87707055"
"2022/07/15","48709765","0","100528650","58788065","208026480"
"2022/07/14","46791100",,"90840830","41016980","178648910"
"2022/07/13","13400030","0","20235935","15713360","49349325"
"2022/07/12","70737355","0","186952165","33119770","290809290"
"2022/07/11","83643660","0","43557080","58249675","185450415"
"2022/07/08","49125610","0","19157095","17219650","85502355"
"2022/07/07","77202780","0","98551675","18381775","194136230"
"2022/07/06","120011960","0","65050240","31715310","216777510"
"2022/07/05","85303875","0","139860390","17666990","242831255"
"2022/07/04","133379125","0","177617870","44145795","355142790"
"2022/07/01","163350805","501000","87684920","46776890","298313615"
"2022/06/30","61668380","0","41320540","68460190","171449110"
"2022/06/29","160202040","5150","81422540","17241180","258870910"
"2022/06/28","102420640","5230","247409250","37427780","387262900"
"2022/06/27","143809530","47130","220845030","75059550","439761240"
"2022/06/24","180467360","16347990","98845360","26622180","322282890"
"2022/06/23","195626340","3686100","69494050","32107440","300913930"
"2022/06/22","267685120","169899950","129098880","15384790","582068740"
"2022/06/21","133581380","63895210","120510570","16501890","334489050"
"2022/06/20","124465210","1056000","183846820","27686790","337054820"
"2022/06/17","11599460","0","301272370","45085480","357957310"
"2022/06/16","67439050","12538260","156274120","41038570","277290000"
"2022/06/15","69024640","0","282354500","27120300","378499440"
"2022/06/14","90635600","0","191316120","44373740","326325460"
"2022/06/13","32488510","0","176139270","21301040","229928820"
"2022/06/10","41007340","0","72042690","19069240","132119270"
"2022/06/09","120416630","63482070","27758430","16504820","228161950"
"2022/06/08","60006710","0","45644650","7031410","112682770"
"2022/06/07","45358830","17520","46755570","10614940","102746860"
"2022/06/03","6819020","0","99468730","8457600","114745350"
"2022/06/02","20183540","231900","59176560","30401040","109993040"
"2022/05/31","11697860","346200","72914790","81480190","166439040"
"2022/05/30","4093630","5770","52471930","13378020","69949350"
"2022/05/27","33515800","7705240","60762650","27980250","129963940"
"2022/05/26","64243560","602550","169406130","34136330","268388570"
"2022/05/25","35100410","11350","165037160","6370870","206519790"
"2022/05/24","20668410","0","58477070","7892820","87038300"
"2022/05/23","17853010","4612930","153148970","24134120","199749030"
"2022/05/20","823530","0","56325820","19206010","76355360"
"2022/05/19","21391070","0","52292680","5311370","78995120"
"2022/05/18","208893350","0","217280920","27596440","453770710"
"2022/05/17","188595760","0","185612180","60807040","435014980"
"2022/05/16","3402800","0","95802420","8110860","107316080"
"2022/05/13","15494750","23060","162179050","13113450","190810310"
"2022/05/12","23206440","5790","143345040","40779780","207337050"
"2022/05/11","1587680","34680","24536270","31093620","57252250"
"2022/05/10","78869650","34037480","254597090","23750730","391254950"
"2022/05/09","13594250","5850000","79812150","8516220","107772620"
"2022/05/06","16305900","0","81120960","11680","97438540"
"2022/05/04","97750020","5870","91042930","36932190","225731010"
"2022/05/03","38907170","0","283414930","25383340","347705440"
"2022/05/02","82269430",,"84840460","1733570","168843460"
"2022/04/29","8775710","0","183560440","44563160","236899310"
"2022/04/28","191305340",,"276624400","39234810","507164550"
"2022/04/27","98217650","0","139707820","10576540","248502010"
"2022/04/26","91263190","4546430","159851440","7721210","263382270"
"2022/04/25","149838060","18246050","196408300","5706790","370199200"
"2022/04/22","103964560","0","166273000","8713600","278951160"
"2022/04/21","57180400","12160000","221122660","2586000","293049060"
"2022/04/20","2238070","3130520","156707750","16930960","179007300"
"2022/04/19","63970200","6010","164142990","20058710","248177910"
"2022/04/18","158344600","59609000","804694860","113751820","1136400280"
"2022/04/15","150535750","6632000","341085740","11865700","510119190"
"2022/04/14","68297020","11972750","359526020","1617780","441413570"
"2022/04/13","140368360","8699750","378926910","8805100","536800120"
"2022/04/12","11734790","8048400","175728320","7487860","202999370"
"2022/04/11","173698470","17316340","54857840","8277440","254150090"
"2022/04/08","117749200","0","153855650","2277070","273881920"
"2022/04/07","20883510","0","126862640","23380790","171126940"
"2022/04/06","19401000","0","285189730","19311620","323902350"
"2022/04/05","43101360","1232440","350811210","27654360","422799370"
"2022/04/04","177448150","0","249942140","42493970","469884260"
"2022/04/01","31142520","0","87456870","59840","118659230"
"2022/03/31","47398880","21740","64764760","26892710","139078090"
"2022/03/30","33053180","167710","47367260","36652430","117240580"
"2022/03/29","55793610","108140","50109310","0","106011060"
"2022/03/28","89544210","18777400","68489740","81000","176892350"
"2022/03/25","88032980","102790","44297670","13062920","145496360"
"2022/03/24","25055600","21620000","1517440","12190340","60383380"
"2022/03/23","55513300","0","117596450","31742160","204851910"
"2022/03/22","11485640","27717880","53814640","18342460","111360620"
"2022/03/21","265580","0","83963090","10176920","94405590"
"2022/03/18","19211920","0","92748820","29913310","141874050"
"2022/03/17","83336570","0","19665450","4123350","107125370"
"2022/03/16","80355710","10515110","31202420","100761680","222834920"
"2022/03/15","136755490","4793260","49915260","22888870","214352880"
"2022/03/14","184560510","0","190756450","9474870","384791830"
"2022/03/11","267055680","0","79519910","6334080","352909670"
"2022/03/10","36445130","0","25486180","6476190","68407500"
"2022/03/08","18203730","0","21675970","9060110","48939810"
"2022/03/07","95223210","46724050","112691150","4462430","259100840"
"2022/03/04","102258500","10690","52137850","2979880","157386920"
"2022/03/03","36866960","0","53237200","101650","90205810"
"2022/03/02","50891920","0","69491520","583900","120967340"
"2022/02/28","75033020","5320","32028910","11022730","118089980"
"2022/02/25","14693190","21280","10154010","2246600","27115080"
"2022/02/24","47337730","1322500","139810740","9834990","198305960"
"2022/02/23","80858960","47181540","31874720","6627480","166542700"
"2022/02/22","37654930","0","61086240","19111170","117852340"
"2022/02/21","33466960","0","50782170","20147830","104396960"
"2022/02/18","54922200","0","80754140","28820790","164497130"
"2022/02/17","243197470","16200000","32388690","48089390","339875550"
"2022/02/16","104263120","32350760","146312230","16112800","299038910"
"2022/02/15","5869200","5360","155608140","29379230","190861930"
"2022/02/14","15886380","5270","142174450","8591620","166657720"
"2022/02/11","53875930","29281280","112168690","16860400","212186300"
"2022/02/10","171252660","22992760","51443430","27635820","273324670"
"2022/02/09","174233490","69347720","17605460","24795810","285982480"
"2022/02/08","96949170","0","154067640","5406830","256423640"
"2022/02/07","129534290","5300","189706070","9980190","329225850"
"2022/02/04","7835540","20950","66523300","78450","74458240"
"2022/02/03","7384430","26165760","192205460","9089230","234844880"
"2022/01/28","3010600","0","74867990","8355500","86234090"
"2022/01/27","40197460","25730","98295110","12359760","150878060"
"2022/01/26","33307610","51400","87157680","18325790","138842480"
"2022/01/25","231855520","46100","150593840","41684520","424179980"
"2022/01/24","89338000","10280","153226930","10034730","252609940"
"2022/01/21","82229530",,"74990070","10994220","168213820"
"2022/01/20","81051440","15520","49907960","36201110","167176030"
"2022/01/19","58187480","0","118799400","8623670","185610550"
"2022/01/18","11447400","0","302003465","7598780","321049645"
"2022/01/17","67532040","10430","147546750","10998700","226087920"
"2022/01/14","4759300","5230","23070340","240120","28074990"
"2022/01/13","11815710","5212350","108145940","0","125174000"
"2022/01/12","213334010","0","68148690","0","281482700"
"2022/01/11","77626630","0","27110890","7149410","111886930"
"2022/01/10","35740970","2625000","251519830","524000","290409800"
"2022/01/07","8079400",,"201816770","0","209896170"
"2022/01/06","149037820","0","98423640","2258440","249719900"
"2022/01/05","189561900","15750","35179430","0","224757080"
"2022/01/04","31734540","5230","177155510","6894540","215789820"
"2022/01/03","69729180","31290","160264820","25260880","255286170"
"2021/12/30","117587840","36520","56246950","25050540","198921850"
"2021/12/29","41819590","26150","126450670","56986470","225282880"
"2021/12/28","265438400","159130","370504400","3814360","639916290"
"2021/12/27","131044630","137870","323002340","1452000","455636840"
"2021/12/24","62843400","0","250742140","0","313585540"
"2021/12/23","20240970","0","136627000",,"156867970"
"2021/12/22","1888630","0","53580440","200760","55669830"
"2021/12/21","7424650","5285280","48978100","4295950","65983980"
"2021/12/20","53126890","0","164261720","33361010","250749620"
"2021/12/17","5111470","100126520","47406820","17398390","170043200"
"2021/12/16","80110930",,"40311370","19231400","139653700"
"2021/12/15","41944550","0","12860850","2761380","57566780"
"2021/12/14","20266580","0","113708340","898740","134873660"
"2021/12/13","58394110",,"591739210","13609920","663743240"
"2021/12/10","148348770","0","29921870","28093570","206364210"
"2021/12/09","94778610",,"11678810","51451340","157908760"
"2021/12/08","5489290","0","80995300","16543330","103027920"
"2021/12/07","18024800","0","76360630","25715830","120101260"
"2021/12/06","110538630","0","198407590","66282290","375228510"
"2021/12/03","139433370","18437290","136390030","17486340","311747030"
"2021/12/02","181216410","21130","29480200","23873170","234590910"
"2021/12/01","245087220","47550","123743390","5230850","374109010"
"2021/11/30","118001590","8616020","172119170","39452250","338189030"
"2021/11/29","153652240","0","105138410","16169210","274959860"
"2021/11/26","334492560","1215240","360646620","23529880","719884300"
"2021/11/25","71808430","0","207794160","2727580","282330170"
"2021/11/24","67033060","0","123406750","0","190439810"
"2021/11/23","114128080","26650000","197053770","16517970","354349820"
"2021/11/22","65505130","0","44601890","27014030","137121050"
"2021/11/19","7410550","763960","128609450",,"136783960"
"2021/11/18","26433540","25038520","38646400","3752000","93870460"
"2021/11/17","122177400","11286630","49217320","15325720","198007070"
"2021/11/16","98908900","32356180","33040580","9796980","174102640"
"2021/11/15","132970050","16180","74176900","6170540","213333670"
"2021/11/12","9717000","0","38606150","10780","48333930"
"2021/11/11","94021130",,"58856040","0","152877170"
"2021/11/10","69901400","0","21319900","2581200","93802500"
"2021/11/09","127867750",,"43716830","1406790","172991370"
"2021/11/08","36146450","10720","34357930","0","70515100"
"2021/11/05","82230030","643200","50414400","0","133287630"
"2021/11/04","82143150","15617730","180194550","15015760","292971190"
"2021/11/03","38270970","0","45009660","11071060","94351690"
"2021/11/02","22089890","0","133465980","37872860","193428730"
"2021/11/01","92797100","0","125713000","9211140","227721240"
"2021/10/29","141402400","0","43447030","2774620","187624050"
"2021/10/28","115177550","32560000","80678380","53888130","282304060"
"2021/10/27","99326920","0","30657750","33691520","163676190"
"2021/10/26","73881400","0","72729130","16673620","163284150"
"2021/10/25","132164670","0","49262630","61807940","243235240"
"2021/10/22","144383270","0","133118550","36035180","313537000"
"2021/10/21","105990060","0","95397170","30216470","231603700"
"2021/10/20","383366730","0","119881330","79619240","582867300"
"2021/10/19","63104820","0","271000100","63608530","397713450"
"2021/10/18","178523120","44271850","356615380","29022380","608432730"
"2021/10/15","124972550","0","194867220","60409520","380249290"
"2021/10/14","102610900","20880000","153731690","15587150","292809740"
"2021/10/13","68515500","131257070","209970000","22154020","431896590"
"2021/10/12","24419020","0","657441650","73543760","755404430"
"2021/10/08","100292150","0","112747100","11375820","224415070"
"2021/10/07","49801810","0","131880130","20210000","201891940"
"2021/10/06","78070760","0","259402170","40721760","378194690"
"2021/10/05","81380110","18296100","103292420","66007040","268975670"
"2021/10/01","60893130","5420450","391103540","11961480","469378600"
"2021/09/30","28792400","0","185964610","49098770","263855780"
"2021/09/29","254933000","0","627666700","26871880","909471580"
"2021/09/28","214891580","0","251859740","12141610","478892930"
"2021/09/27","125996590","0","191049670","0","317046260"
"2021/09/24","73392930","0","119862600","534450","193789980"
"2021/09/23","60538870","0","184664680","40132000","285335550"
"2021/09/17","39823520","0","127708960","2896800","170429280"
"2021/09/16","11791600","0","45256820","0","57048420"
"2021/09/15","36764410","0","336918350","0","373682760"
"2021/09/14","91878880","0","375447240","3784200","471110320"
"2021/09/13","48307460","0","103570960","351900","152230320"
"2021/09/10","6163800","0","81772460","0","87936260"
"2021/09/09","73862040","0","187559780","0","261421820"
"2021/09/08","72231800","0","101411500","1223680","174866980"
"2021/09/07","25510000","0","79288810","0","104798810"
"2021/09/06","51209500","0","47200230","0","98409730"
"2021/09/03","37861360","0","81209030","0","119070390"
"2021/09/02","34723130","5070000","195904840","6996730","242694700"
"2021/09/01","47307190","3802500","172312490","28164770","251586950"
"2021/08/31","2003140","0","152039480","5401710","159444330"
"2021/08/30","58634040","0","72788640","26389680","157812360"
"2021/08/27","12744240","0","173288600","24713390","210746230"
"2021/08/26","15462250","0","107358990","22505760","145327000"
"2021/08/25","32752730","0","153919290","882180","187554200"
"2021/08/24","52037680","30180000","125110030","5019940","212347650"
"2021/08/23","144787070","0","71398040","0","216185110"
"2021/08/20","82745980","37120160","304583580","53846940","478296660"
"2021/08/19","200926470","0","279926240","0","480852710"
"2021/08/18","130799840","0","131167830","4081350","266049020"
"2021/08/17","63922770","0","101110090","5414750","170447610"
"2021/08/13","152886730","0","296814100","19895960","469596790"
"2021/08/12","64652360","0","155003220","0","219655580"
"2021/08/11","167580270","0","144463230","1024140","313067640"
"2021/08/10","124389450","76275580","46786870","21584920","269036820"
"2021/08/09","122272540",,"73758700","9353400","205384640"
"2021/08/06","3877580","0","103129350","0","107006930"
"2021/08/05","80788280","0","28602670","0","109390950"
"2021/08/04","23881650","0","64074230","2377440","90333320"
"2021/08/03","87197630","0","104582270","4463930","196243830"
"2021/08/02","13639220","178150","158230990","11970270","184018630"
"2021/07/30","34495550","2343600","125755280","1348850","163943280"
"2021/07/29","5612460","0","48446060","0","54058520"
"2021/07/28","13364980","0","23744690","0","37109670"
"2021/07/27","6793190",,"90996270","7583620","105373080"
"2021/07/26","28381040",,"112402440","3268660","144052140"
"2021/07/23","5796180",,"141065150","21154040","168015370"
"2021/07/22","102099570",,"29607090","0","131706660"
"2021/07/21","45453570",,"143593890","0","189047460"
"2021/07/20","5110000",,"109847050","15346240","130303290"
"2021/07/19","12294300","15450000","116369130","0","144113430"
"2021/07/16","91390920","0","255876340","0","347267260"
"2021/07/15","41672830",,"239474620","0","281147450"
"2021/07/14","266197160",,"79776220","1812950","347786330"
"2021/07/13","345059320","0","93665580","1755380","440480280"
"2021/07/12","257462380",,"104988760","39547260","401998400"
"2021/07/09","327564760","0","151179660","28284860","507029280"
"2021/07/08","267833890",,"94579490","25922390","388335770"
"2021/07/07","366226720","0","41377970","34710060","442314750"
"2021/07/06","370040460","0","252883600","0","622924060"
"2021/07/05","302539440","1764600","227867370","0","532171410"
"2021/07/02","322913470",,"99018810","1028180","422960460"
"2021/07/01","479770430","17637350","551042450","1067990","1049518220"
"2021/06/30","512900820","0","123977950","54706100","691584870"
"2021/06/29","297433010","61131570","207754990","36150530","602470100"
"2021/06/28","452728110","0","315573520","16148320","784449950"
"2021/06/25","395631250","0","179848410","35881080","611360740"
"2021/06/24","395701350",,"196042390","0","591743740"
"2021/06/23","428168200","90058000","131254490","0","649480690"
"2021/06/22","343449760","0","132730400","17146920","493327080"
"2021/06/21","392182790","0","177666350","8078310","577927450"
"2021/06/18","312515400",,"276102130","2879380","591496910"
"2021/06/17","383124190","20600000","132046210","10052800","545823200"
"2021/06/16","363057530","0","174162880","28048940","565269350"
"2021/06/15","403234750","0","225674610","15096910","644006270"
"2021/06/14","331912780","0","72249730","32049780","436212290"
"2021/06/11","350085460","0","67245060","2124540","419455060"
"2021/06/10","362626730","0","204206370","35603960","602437060"
"2021/06/09","424417920",,"90503370","1258020","516179310"
"2021/06/08","365794310","0","146938660","49137470","561870440"
"2021/06/07","402559070","183050000","74329690","15944210","675882970"
"2021/06/04","262115820","143343050","157844760","92275030","655578660"
"2021/06/03","189851590","0","518871210","77681520","786404320"
"2021/06/02","284886680","0","670586880","23728710","979202270"
"2021/06/01","330132550","26160000","360242410","67959930","784494890"
"2021/05/31","232342340","0","418966690","14683470","665992500"
"2021/05/28","108658440","0","175489160","29298720","313446320"
"2021/05/27","114469180","775200","588056430","80982160","784282970"
"2021/05/26","88883770","0","72097030","67642220","228623020"
"2021/05/25","108580040","0","538245270","17335870","664161180"
"2021/05/24","27175500","0","226503460","9521460","263200420"
"2021/05/21","9009390","0","192785570","3056250","204851210"
"2021/05/20","43288330","92822450","131292550","6873050","274276380"
"2021/05/18","31763460","0","206004140","12640300","250407900"
"2021/05/17","17793320","0","252814050","19945210","290552580"
"2021/05/14","45887770","0","172398430","31516860","249803060"
"2021/05/13","6633270","0","201334120","10621930","218589320"
"2021/05/12","26151840","0","284295770","24392040","334839650"
"2021/05/11","18954720","0","309484480","35516880","363956080"
"2021/05/10","6464000","0","360288400","3684240","370436640"
"2021/05/07","16513130","0","300989190","25040570","342542890"
"2021/05/06","24423360",,"193482440","81300200","299206000"
"2021/05/04","66371590","0","333296060","11057720","410725370"
"2021/05/03","40971070",,"169500390","2479950","212951410"
"2021/04/30","1885810","0","95043610","16198900","113128320"
"2021/04/29","8767000","0","115716000","125500","124608500"
"2021/04/28","32350530","0","117788460","15470000","165608990"
"2021/04/27","12043750","39070000","184624830","21690000","257428580"
"2021/04/26","68138080","0","365504380","17209350","450851810"
"2021/04/23","60717280","0","77758830","0","138476110"
"2021/04/22","62435080","249163695","136573910","22114220","470286905"
"2021/04/21","17322205","0","164407960","20234755","201964920"
"2021/04/20","125301300",,"312765890","23466490","461533680"
"2021/04/19","37154790",,"418257380","2273000","457685170"
"2021/04/16","7323225","0","254497405","54223090","316043720"
"2021/04/15","14464580","0","294659550","0","309124130"
"2021/04/14","488930","0","221539920","8927315","230956165"
"2021/04/13","13069635","38610350","167195860","8017620","226893465"
"2021/04/12","8085065",,"295460735","14215505","317761305"
"2021/04/09","147750","4437000","150056210","14707440","169348400"
"2021/04/08","6789440",,"75271385","5518925","87579750"
"2021/04/07","5396000","0","98263040","4456830","108115870"
"2021/04/06","3073750",,"377604210","17202380","397880340"
"2021/04/05","120270035","0","311347940","5560410","437178385"
"2021/04/02","12840505","15416415","244171965","24553270","296982155"
"2021/04/01","10273115","61459505","168045090","3025715","242803425"
"2021/03/31","12496040","0","121348445","2562360","136406845"
"2021/03/30","26145145",,"115113315","12418995","153677455"
"2021/03/29","25431205","305298515","409670685","32577395","772977800"
"2021/03/26","88125150","2438230","322133155","11927910","424624445"
"2021/03/25","21889850","0","118487270","10572870","150949990"
"2021/03/24","36048085","0","69704570","1116885","106869540"
"2021/03/23","3924485","0","71452095","8388380","83764960"
"2021/03/22","280045820","0","79551085","15404015","375000920"
"2021/03/19","11358080","1825740","94938280","946240","109068340"
"2021/03/18","1444500","2998040","135246585","6475200","146164325"
"2021/03/17","2649860",,"101263220","7280705","111193785"
"2021/03/16","5260590","8829270","63683515","15736415","93509790"
"2021/03/15","1793940","0","97921570","42812485","142527995"
"2021/03/12","10162145",,"81438905","44273385","135874435"
"2021/03/11","1314365",,"41085380","28366880","70766625"
"2021/03/10","207957260","0","63314190","11030170","282301620"
"2021/03/09","150937595","1408500","152933315","9112675","314392085"
"2021/03/08","154920075","0","176795105","8249865","339965045"
"2021/03/05","204912575","0","74620870","22585725","302119170"
"2021/03/04","21836315",,"53948170","114240","75898725"
"2021/03/03","92793000",,"33249205","19564660","145606865"
"2021/03/02","7165270","0","185786065","11746545","204697880"
"2021/02/26","34492245","9530000","69179480","11723150","124924875"
"2021/02/25","44570150","10183950","42306155","15509580","112569835"
"2021/02/24","275987335",,"88056300","5866410","369910045"
"2021/02/23","236576490","0","157475510","3400900","397452900"
"2021/02/22","237754255","0","501487670","8303490","747545415"
"2021/02/19","251405710","0","744245460","16763945","1012415115"
"2021/02/18","316523135","0","139781780","16361720","472666635"
"2021/02/17","336118215","0","109269175","4942150","450329540"
"2021/02/16","393544095",,"173818135","4951140","572313370"
"2021/02/15","191764565",,"194240160","3036780","389041505"
"2021/02/10","32259950","0","156080420","27600950","215941320"
"2021/02/09","4845000",,"117898995","6886400","129630395"
"2021/02/08","52400640","0","44247915","0","96648555"
"2021/02/05","35535765","0","386343495","13393945","435273205"
"2021/02/04","21788095","0","104325455","0","126113550"
"2021/02/03","33103110","0","127752745",,"160855855"
"2021/02/02","70948085","0","145936185","2844870","219729140"
"2021/02/01","50113060",,"62160125","0","112273185"
"2021/01/29","1819025",,"125829025","1080800","128728850"
"2021/01/28","14554060","0","142459335","7945485","164958880"
"2021/01/27","9695150",,"79292425","4903140","93890715"
"2021/01/26","14875070","0","96138110","7968080","118981260"
"2021/01/25","34812400","0","95187730","0","130000130"
"2021/01/22","48138620","0","153688065","51746635","253573320"
"2021/01/21","5824695","0","488532850","25553110","519910655"
"2021/01/20","13523500","0","135185460","4094930","152803890"
"2021/01/19","116016320",,"259457640","1449000","376922960"
"2021/01/18","93691755",,"93280300","13103190","200075245"
"2021/01/15","8353500",,"87402270","9749620","105505390"
"2021/01/14","64981510",,"137674420","4625215","207281145"
"2021/01/13","1160840","0","70898235","2657360","74716435"
"2021/01/12","117960915","0","140515275","5187920","263664110"
"2021/01/11","45244700","0","729755295","57655295","832655290"
"2021/01/08","37178450","0","518679555","33707120","589565125"
"2021/01/07","27110700","0","356442250","3306375","386859325"
"2021/01/06","223219960","97017050","194882555","24619705","539739270"
"2021/01/05","31253870","387808155","481911085","58181555","959154665"
"2021/01/04","4273315","0","618909695","85622560","708805570"
"2020/12/30","523505","18275020","213055610","39492430","271346565"
"2020/12/29","150974610","14071520","493216600","19073260","677335990"
"2020/12/28","291355080","0","432738570","19540080","743633730"
"2020/12/24","25230","0","548096610","13985350","562107190"
"2020/12/23","50717440","0","216424270","35919350","303061060"
"2020/12/22","185827330","0","217279130","10175750","413282210"
"2020/12/21","98618200","0","157791150","0","256409350"
"2020/12/18","135825460","0","185455270","90720","321371450"
"2020/12/17","17605150","0","210432490","3887760","231925400"
"2020/12/16","3974080","0","105602690","7670310","117247080"
"2020/12/15","1030255","0","122013925","0","123044180"
"2020/12/14","125306200","454805030","247600995","76157770","903869995"
"2020/12/11","151229370","199735380","37397990","3776220","392138960"
"2020/12/10","125784420","99782395","151517635","38988290","416072740"
"2020/12/09","108976355","150600","131731405","22258605","263116965"
"2020/12/08","128545205","656310","49599190","5225460","184026165"
"2020/12/07","205243360","0","138250750","5065000","348559110"
"2020/12/04","90475000","0","255909850","6535000","352919850"
"2020/12/03","108095150",,"331716850","135540","439947540"
"2020/12/02","171087330",,"164268850","0","335356180"
"2020/12/01","186379320","0","150950780","13792570","351122670"
"2020/11/30","136136040","0","281624500","10034390","427794930"
"2020/11/27","62840040","0","215073640","50696610","328610290"
"2020/11/26","117409910","50600000","99599400","6817580","274426890"
"2020/11/25","103439390","0","159043840","15210","262498440"
"2020/11/24","343204410",,"228964440","60520930","632689780"
"2020/11/23","69357030","0","280659960","47981040","397998030"
"2020/11/20","360615480","0","160053190","68159780","588828450"
"2020/11/19","394230250","196560","80470600","15518160","490415570"
"2020/11/18","290341680","0","97195900","5946780","393484360"
"2020/11/17","106356730","0","271740470","10389780","388486980"
"2020/11/16","133309890","0","138445290","23721360","295476540"
"2020/11/13","250429090","0","182977490","65680","433472260"
"2020/11/12","373384230","0","82050940","317960","455753130"
"2020/11/11","176223260","0","385130340","50417510","611771110"
"2020/11/10","128154570","0","133603290","36959050","298716910"
"2020/11/09","107401600","659100","322343460","61703490","492107650"
"2020/11/06","107986420","0","191492470","9462110","308941000"
"2020/11/05","198714360",,"281833060","27158650","507706070"
"2020/11/04","257389200","0","183050060","66184370","506623630"
"2020/11/03","322292300","1305090","181168230","96334170","601099790"
"2020/11/02","345292110","1075340","430913060","162503900","939784410"
"2020/10/30","140823420","67562210","434479800","58472800","701338230"
"2020/10/29","109406290","133087310","380403870","16443750","639341220"
"2020/10/28","77795620","86585750","369847980","142021940","676251290"
"2020/10/27","38938510","226066760","392134130","124915140","782054540"
"2020/10/26","89428350","197340","738690210","448169530","1276485430"
"2020/10/23","231511410","0","1053586180","53286540","1338384130"
"2020/10/22","78352810","0","573993640","33669995","686016445"
"2020/10/21","55249250","0","215889990","13861540","285000780"
"2020/10/20","72733170","0","214168855","47749810","334651835"
"2020/10/19","137872120","0","480961145","42415175","661248440"
"2020/10/16","101693990",,"418597310","33569550","553860850"
"2020/10/15","246980535","15153850","426307365","18246450","706688200"
"2020/10/14","135462795","180188865","312321905","50426240","678399805"
"2020/10/13","58475295","9930000","135182530","32772015","236359840"
"2020/10/12","119885560",,"245319825","176747300","541952685"
"2020/10/08","266342535","0","865060005","117661245","1249063785"
"2020/10/07","308433450","2472500","593180035","153812715","1057898700"
"2020/10/06","337453950","73768620","458212280","57023530","926458380"
"2020/10/05","284131035",,"312564300","17462440","614157775"
"2020/09/29","73760810",,"307060870","8075745","388897425"
"2020/09/28","114186535","0","141922190","11065485","267174210"
"2020/09/25","80345685","0","196402995","56890640","333639320"
"2020/09/24","260171340","0","408804390","9501025","678476755"
"2020/09/23","124757985","0","153413320","26140510","304311815"
"2020/09/22","140897740","0","123018660","21314555","285230955"
"2020/09/21","23525000","0","351675595","9685290","384885885"
"2020/09/18","48299980","0","179068685","14386620","241755285"
"2020/09/17","126159285","1240065","726933060","85775395","940107805"
"2020/09/16","106209165","1069300","324892260","3855155","436025880"
"2020/09/15","144699295","0","97505320","15985925","258190540"
"2020/09/14","265967770","9030000","129598255","11824785","416420810"
"2020/09/11","204905400","0","157709685","11077760","373692845"
"2020/09/10","145881110","0","86258170","22541645","254680925"
"2020/09/09","244395775","0","178012385","44073745","466481905"
"2020/09/08","193706375","0","177700810","10214535","381621720"
"2020/09/07","215819370","0","235831795","4880030","456531195"
"2020/09/04","83486710","0","445024295","1347000","529858005"
"2020/09/03","147468795","0","91035735","4222715","242727245"
"2020/09/02","74254525",,"126371760","23210370","223836655"
"2020/09/01","202145740","0","163323385","1960050","367429175"
"2020/08/31","186054030","0","497786545","4300140","688140715"
"2020/08/28","128571055","0","122190620","0","250761675"
"2020/08/27","132127080","0","434898860","0","567025940"
"2020/08/26","189797875","0","257390775","0","447188650"
"2020/08/25","62673875","0","194981515","0","257655390"
"2020/08/24","72420080","0","372280750","10146415","454847245"
"2020/08/21","113846400","0","179292755","1676485","294815640"
"2020/08/20","40986215","0","417902965","20179070","479068250"
"2020/08/19","92364245","0","221648615","0","314012860"
"2020/08/18","225512935","0","292598580","0","518111515"
"2020/08/14","236409695","1868000","368210945","0","606488640"
"2020/08/13","60798320","0","366803480","49252490","476854290"
"2020/08/12","353662805","4600000","1407478725","152991090","1918732620"
"2020/08/11","249663870","4500000","1114640405","76214625","1445018900"
"2020/08/10","58540345","20346080","1334769645","2781280","1416437350"
"2020/08/07","91308790","0","803716200","7039345","902064335"
"2020/08/06","423340830","4265000","1551902445","9473300","1988981575"
"2020/08/05","2722336290","74825800","7286222720","9677570","10093062380"