일자,기관 합계,기타법인,개인,외국인 합계,전체
"2023/05/04","1460559","234524","33845483","2854493","38395059"
"2023/05/03","8562569","15223","70756177","571403","79905372"
"2023/05/02","187619","0","43914576","2043176","46145371"
"2023/04/28","141367","17143","67558105","4718487","72435102"
"2023/04/27","14723387","2954","131988103","9564135","156278579"
"2023/04/26","16462437","0","124913568","575404","141951409"
"2023/04/25","1066121","4238614","394885863","2058148","402248746"
"2023/04/24","984445","1998","99582791","5041754","105610988"
"2023/04/21","658790","0","128888375","2976139","132523304"
"2023/04/20","588563","3061","100700421","6614122","107906167"
"2023/04/19","7955354","0","588994555","7929911","604879820"
"2023/04/18","17543545","3004","883310130","3178328","904035007"
"2023/04/17","19014023","8025","273453884","2693214","295169146"
"2023/04/14","6808286","965","184604577","406116","191819944"
"2023/04/13","7198842","1902","73071637","1051809","81324190"
"2023/04/12","6151284","1887","69310862","336123","75800156"
"2023/04/11","4266272","923","98502781","11973","102781949"
"2023/04/10","6133048","912","101001751","373102","107508813"
"2023/04/07","1162822","913","66130341","1828","67295904"
"2023/04/06","848088","0","113309910","1106966","115264964"
"2023/04/05","363161","0","74031804","2537693","76932658"
"2023/04/04","210032","0","50584057","712338","51506427"
"2023/04/03","4041697","0","34366022","4462961","42870680"
"2023/03/31","173424","8136750","239308072","5979494","253597740"
"2023/03/30","4073613","1631370","50458929","6101080","62264992"
"2023/03/29","26948184","0","47691920","5436293","80076397"
"2023/03/28","6254080","0","17436909","5767191","29458180"
"2023/03/27","232049","899","43124865","2556786","45914599"
"2023/03/24","201161","1605950","118350767","4975488","125133366"
"2023/03/23","16113333","1298935","74461188","5403304","97276760"
"2023/03/22","26790","1693440","30108925","4595326","36424481"
"2023/03/21","93376","0","19463713","5457134","25014223"
"2023/03/20","59334","0","32293638","4741988","37094960"
"2023/03/17","1528567","12665","35812685","5464101","42818018"
"2023/03/16","19739359","7133","53589382","5220626","78556500"
"2023/03/15","953724","0","66412650","5342763","72709137"
"2023/03/14","34034496","1788","77332916","5789081","117158281"
"2023/03/13","3841508","7953","93309184","7092567","104251212"
"2023/03/10","510566","0","39189014","5211972","44911552"
"2023/03/09","3049888","1793","112798517","5031823","120882021"
"2023/03/08","995543","890","61942215","5170433","68109081"
"2023/03/07","698016","868449","90421364","5511280","97499109"
"2023/03/06","2864961","869","58272311","5236936","66375077"
"2023/03/03","1779321","4900278","20884275","8078002","35641876"
"2023/03/02","403096","604942","33133746","4662423","38804207"
"2023/02/28","7857","405636","13173777","5265796","18853066"
"2023/02/27","3532","0","50637485","5585688","56226705"
"2023/02/24","1561965","0","41320436","4372331","47254732"
"2023/02/23","39700","1758","65821844","5029021","70892323"
"2023/02/22","54191","1013150","95127766","5824565","102019672"
"2023/02/21","14176","762870","20179481","5761149","26717676"
"2023/02/20","10073912","1768","36606016","3735075","50416771"
"2023/02/17","937385","0","21279389","1634797","23851571"
"2023/02/16","3541484","883","21878749","2072285","27493401"
"2023/02/15","10925592","8823","33599876","5094245","49628536"
"2023/02/14","935952","0","22557792","949181","24442925"
"2023/02/13","1008605","881","61345593","858756","63213835"
"2023/02/10","2690733","0","29960634","540843","33192210"
"2023/02/09","896000","0","46293297","12572","47201869"
"2023/02/08","241850","902","49889456","4063698","54195906"
"2023/02/07","418061","901","15253353","458149","16130464"
"2023/02/06","15961832","0","15993209","234519","32189560"
"2023/02/03","5059801","71044","103491930","345509","108968284"
"2023/02/02","53081319","8113","83482473","142861","136714766"
"2023/02/01","688116","0","75883521","53230","76624867"
"2023/01/31","58730","0","16884102","140734","17083566"
"2023/01/30","141904","0","27841255","7291","27990450"
"2023/01/27","232060","0","36668890","3438890","40339840"
"2023/01/26","402313","904","35803482","1198798","37405497"
"2023/01/25","583641","0","20425059","903","21009603"
"2023/01/20","827073","894","60235624","216807","61280398"
"2023/01/19","7112","0","15638778","279693","15925583"
"2023/01/18","688721","1789","23617832","9874","24318216"
"2023/01/17","1827295","0","60636784","782412","63246491"
"2023/01/16","38056774","0","57456082","0","95512856"
"2023/01/13","781704","0","33936448","3325478","38043630"
"2023/01/12","675797","0","23538015","3956347","28170159"
"2023/01/11","434938","888","64061209","1415022","65912057"
"2023/01/10","1826854","0","26482106","275519","28584479"
"2023/01/09","1425503","881","33816230","169596","35412210"
"2023/01/06","2910106","0","65878580","5254","68793940"
"2023/01/05","215407","0","42662957","2432800","45311164"
"2023/01/04","60030","870","27755273","2102838","29919011"
"2023/01/03","350207","0","27713852","5094151","33158210"
"2023/01/02","2733299","0","11413027","3402872","17549198"
"2022/12/29","8417485","0","98208525","7317325","113943335"
"2022/12/28","16837643","36373745","87173096","10861797","151246281"
"2022/12/27","20238823","18944780","98396281","710863","138290747"
"2022/12/26","110714","42935662","34726948","1910240","79683564"
"2022/12/23","95300","950","21320866","1517787","22934903"
"2022/12/22","190800","3810","23476589","596953","24268152"
"2022/12/21","290752","949","11975838","415748","12683287"
"2022/12/20","8780905","1907","19889532","2797277","31469621"
"2022/12/19","2815614","0","49214328","822337","52852279"
"2022/12/16","144622","0","78890154","849994","79884770"
"2022/12/15","8902058","909362","34443142","868592","45123154"
"2022/12/14","28740","0","20463383","661093","21153216"
"2022/12/13","226127","0","39840570","525366","40592063"
"2022/12/12","9803468","0","37364105","2977833","50145406"
"2022/12/09","5122362","0","23312830","1543957","29979149"
"2022/12/08","2025726","0","20818059","1585668","24429453"
"2022/12/07","579142","0","30608150","792755","31980047"
"2022/12/06","351076","0","44077571","2389509","46818156"
"2022/12/05","15876389","3824","64898108","507632","81285953"
"2022/12/02","2480548","1849","156745043","2675983","161903423"
"2022/12/01","841373","4604","114645590","798305","116289872"
"2022/11/30","1293070","2755","76654281","205979","78156085"
"2022/11/29","386004","6444","15726879","530618","16649945"
"2022/11/28","103847","0","43606998","2511363","46222208"
"2022/11/25","2547046","0","40541694","18527","43107267"
"2022/11/24","1008627","0","85996627","235140","87240394"
"2022/11/23","4630","0","117226482","436575","117667687"
"2022/11/22","11367701","0","27971716","765546","40104963"
"2022/11/21","917","0","30469978","954387","31425282"
"2022/11/18","48724","0","26474432","701102","27224258"
"2022/11/17","252176","0","11271379","266656","11790211"
"2022/11/16","8877757","0","32596467","3645906","45120130"
"2022/11/15","1602318","0","28593031","3039159","33234508"
"2022/11/14","6111138","0","44103288","4179101","54393527"
"2022/11/11","51789447","0","82974045","8518274","143281766"
"2022/11/10","1658614","0","54190926","5034549","60884089"
"2022/11/09","1014304","0","80412272","8001733","89428309"
"2022/11/08","14145013","0","68485555","7840870","90471438"
"2022/11/07","345835","2652","16392757","2503311","19244555"
"2022/11/04","459984","14977","22530558","4228813","27234332"
"2022/11/03","10571444","0","35623715","7700985","53896144"
"2022/11/02","1753745","0","16486867","3964395","22205007"
"2022/11/01","11936660","0","46908952","660703","59506315"
"2022/10/31","10347478","0","19726673","369476","30443627"
"2022/10/28","7008","0","26039072","1034447","27080527"
"2022/10/27","183079","0","86399099","424737","87006915"
"2022/10/26","4969572","0","29388678","1028129","35386379"
"2022/10/25","1232882","5261","38223803","86751","39548697"
"2022/10/24","401277","12347","30585892","642053","31641569"
"2022/10/21","437296","0","31241680","3861163","35540139"
"2022/10/20","16162664","0","32750314","3304560","52217538"
"2022/10/19","2970987","0","68518022","691062","72180071"
"2022/10/18","4237493","0","54455642","71401","58764536"
"2022/10/17","2607229","881","67120182","628985","70357277"
"2022/10/14","2599362","0","30199618","680234","33479214"
"2022/10/13","4188227","0","203975137","6855881","215019245"
"2022/10/12","59793","0","36712702","948604","37721099"
"2022/10/11","149326","0","70708237","6917994","77775557"
"2022/10/07","8394654","0","35803460","86804","44284918"
"2022/10/06","1702179","0","34696771","634441","37033391"
"2022/10/05","131153","0","60283568","3785473","64200194"
"2022/10/04","4017825","0","41437996","391788","45847609"
"2022/09/30","1195700","922","53856661","2589589","57642872"
"2022/09/29","36941685","0","41033085","987725","78962495"
"2022/09/28","247546","0","129602183","12297576","142147305"
"2022/09/27","1230818","0","127872629","13473347","142576794"
"2022/09/26","26934743","0","242328692","25269115","294532550"
"2022/09/23","67090296","0","79332320","10775363","157197979"
"2022/09/22","570590","0","41323070","6839975","48733635"
"2022/09/21","51245","0","48857300","941490","49850035"
"2022/09/20","50470",,"36553065","3090","36606625"
"2022/09/19","2749500",,"65753875","27415570","95918945"
"2022/09/16","1458640","0","31045480","2752185","35256305"
"2022/09/15","10269050","1055","42790870","2149715","55210690"
"2022/09/14","12794070",,"91972170","3255630","108021870"
"2022/09/13","948035",,"60295275","646355","61889665"
"2022/09/08","346725","0","35559185","1186540","37092450"
"2022/09/07","1958320","1020","55396265","11458200","68813805"
"2022/09/06","361780","0","37424465","942495","38728740"
"2022/09/05","30750","0","93349540","1769165","95149455"
"2022/09/02","273415","0","76291920","2070","76567405"
"2022/09/01","54026910","35072200","115301440","17779820","222180370"
"2022/08/31","1350810","2879585","37480680","7591145","49302220"
"2022/08/30","11350930","1634480","122051040","25209595","160246045"
"2022/08/29","731840","11857850","180670935","9605880","202866505"
"2022/08/26","4267755","1667700","34408365","12356615","52700435"
"2022/08/25","29799480","0","21358880","6025300","57183660"
"2022/08/24","618010","0","130394960","25769300","156782270"
"2022/08/23","1246885","0","91908750","6188645","99344280"
"2022/08/22","2100630","0","45047810","17906930","65055370"
"2022/08/19","38240","399375","153807575","9005450","163250640"
"2022/08/18","10424705","2402450","77627930","17395055","107850140"
"2022/08/17","977370","0","43759415","12837200","57573985"
"2022/08/16","11310840","0","110850390","11863475","134024705"
"2022/08/12","15416695","2122450","107718715","6102250","131360110"
"2022/08/11","3913385","4446000","108140885","11671395","128171665"
"2022/08/10","16462135","0","51394380","5510175","73366690"
"2022/08/09","1069250","1755000","26584935","31780125","61189310"
"2022/08/08","58720","3378000","48076940","6742105","58255765"
"2022/08/05","6847490","4258240","67676470","2676040","81458240"
"2022/08/04","124570","14725130","105654380","20706260","141210340"
"2022/08/03","5156320","12581530","39351960","11767575","68857385"
"2022/08/02","10029655","17014080","67028580","32179525","126251840"
"2022/08/01","414720","17655660","62967110","17979250","99016740"
"2022/07/29","2604385","26205855","116341520","16999375","162151135"
"2022/07/28","5071525","23760","45585905","27254255","77935445"
"2022/07/27","2496015","2169360","70248025","13082275","87995675"
"2022/07/26","4611820","1070","58212200","24889655","87714745"
"2022/07/25","15815300","12710","90870485","10882840","117581335"
"2022/07/22","4016880","1829700","103050850","22708040","131605470"
"2022/07/21","182595","0","115667620","5643265","121493480"
"2022/07/20","3171495","3185","203927610","10135140","217237430"
"2022/07/19","14432715","4175","155923400","3748900","174109190"
"2022/07/18","745010","20650000","93328765","1346535","116070310"
"2022/07/15","9009130","0","136228170","1591140","146828440"
"2022/07/14","10254755","0","178213135","6407480","194875370"
"2022/07/13","43060","0","57459160","8399290","65901510"
"2022/07/12","1233940","1035","214463800","83191910","298890685"
"2022/07/11","37745","1060","171296265","6795965","178131035"
"2022/07/08","4550905","245240","184887525","20569610","210253280"
"2022/07/07","1006535","0","97564115","13063885","111634535"
"2022/07/06","1055","3180","83938740","11463985","95406960"
"2022/07/05","2178355","0","45031330","2292335","49502020"
"2022/07/04","4240","0","141163150","58177245","199344635"
"2022/07/01","1858430","0","41959510","58248480","102066420"
"2022/06/30","940440","10982850","41521360","53227545","106672195"
"2022/06/29","4020620","0","120359290","41845165","166225075"
"2022/06/28","2604940","1120","218573520","23707195","244886775"
"2022/06/27","4641640","0","106682970","24668255","135992865"
"2022/06/24","5115480","1837175","91995685","20272530","119220870"
"2022/06/23","30806415","0","312174875","137117815","480099105"
"2022/06/22","612095","0","585913645","70022315","656548055"
"2022/06/21","832645","572500","163612580","24828215","189845940"
"2022/06/20","844150","1922625","572606470","105248325","680621570"
"2022/06/17","4752800","0","570022095","53063290","627838185"
"2022/06/16","42150165","0","173302745","34923010","250375920"
"2022/06/15","272080","14895","164159225","51835530","216281730"
"2022/06/14","12656495","2109790","369141845","28285925","412194055"
"2022/06/13","355195","0","311462575","88675565","400493335"
"2022/06/10","17103885","0","103229835","31586450","151920170"
"2022/06/09","1157225","1315","68659425","41443250","111261215"
"2022/06/08","1302495","2245430","171427770","9014960","183990655"
"2022/06/07","912225","823315","136575635","21196100","159507275"
"2022/06/03","13816295","0","203580685","56075065","273472045"
"2022/06/02","1299635","0","145475085","30172855","176947575"
"2022/05/31","7486345","0","403806870","38119930","449413145"
"2022/05/30","6101550","0","115630480","3373210","125105240"
"2022/05/27","1360","1375","492790600","7919180","500712515"
"2022/05/26","22498265","34535","340076875","981215","363590890"
"2022/05/25","2770","0","363579400","2427105","366009275"
"2022/05/24","10639270","0","117605575","22225525","150470370"
"2022/05/23","20724820","0","182428690","18521185","221674695"
"2022/05/20","5735","0","85261950","4159875","89427560"
"2022/05/19","4549320","0","210137310","24659510","239346140"
"2022/05/18","8546550","19933955","160609780","21416355","210506640"
"2022/05/17","3621440","57427325","114314945","23469410","198833120"
"2022/05/16","22067315","29520335","243864850","16458585","311911085"
"2022/05/13","23017420","19307500","647646375","43398000","733369295"
"2022/05/12","45342565","1117930","583356455","312617180","942434130"
"2022/05/11","561735","11240","141129995","80905865","222608835"
"2022/05/10","72325350","429885","291253485","31428035","395436755"
"2022/05/09","1130500","0","386019950","69321015","456471465"
"2022/05/06","12410205","0","258965960","29383395","300759560"
"2022/05/04","43848240","2950","321643080","113914315","479408585"
"2022/05/03","17669560","2990","235926995","55271270","308870815"
"2022/05/02","12011640","1500","342361420","41606235","395980795"
"2022/04/29","15407940","6055000","177612280","54366890","253442110"
"2022/04/28","5628590","3789740","258554450","107137305","375110085"
"2022/04/27","9036485","1224150","218778770","52361100","281400505"
"2022/04/26","3113425","21057500","546864310","39444690","610479925"
"2022/04/25","16930925","14947505","487158530","49888485","568925445"
"2022/04/22","3472990","1505","142040350","52364820","197879665"
"2022/04/21","3022180","9554000","323995230","26162995","362734405"
"2022/04/20","6864125","281060","423771340","40354785","471271310"
"2022/04/19","186185","120400","266356730","97049175","363712490"
"2022/04/18","2742985","2326505","816977810","108445330","930492630"
"2022/04/15","29574090","9098500","684464785","311720860","1034858235"
"2022/04/14","432190","6460","188810785","192721130","381970565"
"2022/04/13","35687265","0","858749070","141946440","1036382775"
"2022/04/12","3546525","0","370839435","111915795","486301755"
"2022/04/11","10172010","1650","644207385","66527035","720908080"
"2022/04/08","19741650","0","458356020","146291230","624388900"
"2022/04/07","5884235","3225","623808545","93582390","723278395"
"2022/04/06","3893395","11380","448840010","31984395","484729180"
"2022/04/05","16671855","8130","484590670","79245810","580516465"
"2022/04/04","4783810","14755","589483065","121736430","716018060"
"2022/04/01","9865635","8283380","743087770","50841830","812078615"
"2022/03/31","33438120","11224505","654835455","193456235","892954315"
"2022/03/30","31990095","58982410","1091253685","247175230","1429401420"
"2022/03/29","8416125","19318200","411981170","249012970","688728465"
"2022/03/28","61850635","43612500","1364120565","111547395","1581131095"
"2022/03/25","83023705","35971110","1373186175","369514655","1861695645"
"2022/03/24","14584585","62317540","786402330","46892640","910197095"
"2022/03/23","29077225","61265000","765258050","70311070","925911345"
"2022/03/22","3680385","0","297554900","41747290","342982575"
"2022/03/21","2321080","8020545","145197135","43402720","198941480"
"2022/03/18","4589075","0","55746745","33644000","93979820"
"2022/03/17","953565","1535000","523968310","123779975","650236850"
"2022/03/16","21012005","7610000","195114735","79054365","302791105"
"2022/03/15","7569570","7576500","136927565","44814240","196887875"
"2022/03/14","304515","7594820","368065275","72180495","448145105"
"2022/03/11","14155135","75310770","1007866295","46776385","1144108585"
"2022/03/10","5266500","0","388765450","55728710","449760660"
"2022/03/08","24341500","0","324822160","90407580","439571240"
"2022/03/07","305140","3211400","687020205","185903180","876439925"
"2022/03/04","19211950","2349000","1644943765","141088685","1807593400"
"2022/03/03","124054310","815000","2334482305","653810260","3113161875"
"2022/03/02","79461915","57945000","1409584905","314189785","1861181605"
"2022/02/28","38619455","49012500","783880115","212358580","1083870650"
"2022/02/25","10809480","17087500","694676105","32254730","754827815"
"2022/02/24","9692775","1530","969076475","31404620","1010175400"
"2022/02/23","15777075","14055000","414933070","64672030","509437175"
"2022/02/22","64211405","12845000","817737345","117494055","1012287805"
"2022/02/21","17459005","49254355","1118395240","489574995","1674683595"
"2022/02/18","27606105","84622525","1322748935","136147445","1571125010"
"2022/02/17","14660","0","495816240","127392200","623223100"
"2022/02/16","89538310","0","612746535","58297100","760581945"
"2022/02/15","111540","0","378969915","71486295","450567750"
"2022/02/14","2909315","0","826370755","146101005","975381075"
"2022/02/11","5583970","4466450","792222600","126810335","929083355"
"2022/02/10","22453310","57750","314041230","77408205","413960495"
"2022/02/09","86227015","72873290","1445666010","261855800","1866622115"
"2022/02/08","94247125","0","2372452205","414903520","2881602850"
"2022/02/07","1275","25385","90051020","28454605","118532285"
"2022/02/04","3491965","26455","110143030","7939260","121600710"
"2022/02/03","3976290","5055","202949070","14251770","221182185"
"2022/01/28","1221505","0","189607340","17098005","207926850"
"2022/01/27","185520","1230","159131625","57130110","216448485"
"2022/01/26","321100","11140","167069915","74823805","242225960"
"2022/01/25","16688490","0","301485570","54172590","372346650"
"2022/01/24","0","0","167937545","36041580","203979125"
"2022/01/21","263500","2630","80404565","21187295","101857990"
"2022/01/20","3947500","0","133481270","6412850","143841620"
"2022/01/19","4313505","0","215097920","14328875","233740300"
"2022/01/18","8239175","0","163765795","51708310","223713280"
"2022/01/17","5434950","0","131999700","58576285","196010935"
"2022/01/14","68000","0","118122545","46739735","164930280"
"2022/01/13","2035000","2730","164399865","18119310","184556905"
"2022/01/12","41300","0","118164795","9836765","128042860"
"2022/01/11","576345","0","305773995","67154440","373504780"
"2022/01/10","25485690","2740","263061755","75103870","363654055"
"2022/01/07","1410","2805","133871135","12482550","146357900"
"2022/01/06","9840","0","217706305","18088435","235804580"
"2022/01/05","29387495","11255","169398705","6069355","204866810"
"2022/01/04","781740","2815","186977395","11606440","199368390"
"2022/01/03","2812825","0","182384170","34118710","219315705"
"2021/12/30","170375","0","174530735","58353835","233054945"
"2021/12/29","9545935","0","173266725","82747955","265560615"
"2021/12/28","39829295","5995","473658705","19342215","532836210"
"2021/12/27","15318410","0","350436875","65100040","430855325"
"2021/12/24","37044495","0","402899645","8058910","448003050"
"2021/12/23","324025","1465","274902095","56946445","332174030"
"2021/12/22","5604075","0","137124600","23010435","165739110"
"2021/12/21","1338130","0","276884005","35421685","313643820"
"2021/12/20","8685310","0","304844260","47270995","360800565"
"2021/12/17","6906420","1450","138279355","1751600","146938825"
"2021/12/16","356980","0","148942570","34445775","183745325"
"2021/12/15","118520","0","121134340","13389715","134642575"
"2021/12/14","1455","0","108829040","13780460","122610955"
"2021/12/13","590495","47855","206758210","2584200","209980760"
"2021/12/10","2906440","0","147873935","10646685","161427060"
"2021/12/09","20355","0","164021965","3703300","167745620"
"2021/12/08","248020","0","182838320","22651415","205737755"
"2021/12/07","10120","1445","159635315","10834645","170481525"
"2021/12/06","4203495","4325","166776615","32080890","203065325"
"2021/12/03","2108675","53970","159883720","29120240","191166605"
"2021/12/02","469150",,"227356990","30788445","258614585"
"2021/12/01","36696205","0","241517730","16929505","295143440"
"2021/11/30","22345400","0","655436385","68286905","746068690"
"2021/11/29","35641625","0","397667940","39942495","473252060"
"2021/11/26","11263805",,"404417045","18677605","434358455"
"2021/11/25","278790","0","197416775","5314425","203009990"
"2021/11/24","6431015","0","230081165","15752725","252264905"
"2021/11/23","11680885","0","253626525","9985260","275292670"
"2021/11/22","19019350","0","311740685","34330930","365090965"
"2021/11/19","23523060","1500","294214460","9111725","326850745"
"2021/11/18","33247510","0","294597440","42157350","370002300"
"2021/11/17","31391865","0","626250265","31618525","689260655"
"2021/11/16","19213750","0","800786330","144142695","964142775"
"2021/11/15","1785100",,"517605245","69419430","588809775"
"2021/11/12","11334405","95280","502440100","48755970","562625755"
"2021/11/11","34914850","0","597533175","79235505","711683530"
"2021/11/10","16253745","122800","1004323370","87176865","1107876780"
"2021/11/09","112650605","36385","2358784185","572561625","3044032800"
"2021/11/08","213004200","0","3327092375","370316765","3910413340"
"2021/11/05","10686260","4135590","502070635","39109470","556001955"
"2021/11/04","1601850","0","431178440","94034210","526814500"
"2021/11/03","6328620",,"501661615","54875850","562866085"
"2021/11/02","33164045","0","676349165","59052495","768565705"
"2021/11/01","23687675",,"728903080","27555425","780146180"
"2021/10/29","9530725","0","544507915","35509110","589547750"
"2021/10/28","5969735",,"337032515","32899905","375902155"
"2021/10/27","40323495",,"233079920","37213335","310616750"
"2021/10/26","11266100","3684080","637119055","97390410","749459645"
"2021/10/25","2753975","0","375464640","34759595","412978210"
"2021/10/22","65955115","0","560332665","108795900","735083680"
"2021/10/21","5959915",,"203927235","104128225","314015375"
"2021/10/20","15571720",,"440834875","12301835","468708430"
"2021/10/19","5547435",,"246778830","3822945","256149210"
"2021/10/18","11398390","0","393662830","32264010","437325230"
"2021/10/15","20122870",,"448487615","31880170","500490655"
"2021/10/14","21052795",,"363107900","38027390","422188085"
"2021/10/13","36520595",,"249409240","65245275","351175110"
"2021/10/12","10305440",,"423899600","101024560","535229600"
"2021/10/08","101759080",,"810146260","221460835","1133366175"
"2021/10/07","44862190","1455000","1313941490","302035270","1662293950"
"2021/10/06","22494670",,"1022926045","278640080","1324060795"
"2021/10/05","46129820","8170380","643655790","145605075","843561065"
"2021/10/01","9573550","9060285","757447510","77890505","853971850"
"2021/09/30","20241085",,"449525460","37302955","507069500"
"2021/09/29","35178520",,"793178670","115138535","943495725"
"2021/09/28","20561175","0","872435440","80244750","973241365"
"2021/09/27","38012890","800000","679739700","107679000","826231590"
"2021/09/24","29203875","0","843572010","64420810","937196695"
"2021/09/23","12153140","0","1867668305","136055220","2015876665"
"2021/09/17","18268255","0","1182511840","40866675","1241646770"
"2021/09/16","29516475","0","1310972145","149918220","1490406840"
"2021/09/15","40038495","0","1592930910","75634895","1708604300"
"2021/09/14","104968780","1730","2008599735","272808715","2386378960"
"2021/09/13","26443840",,"3448049560","221141565","3695634965"
"2021/09/10","325466405","39272245","20778214755","1551203680","22694157085"
"2021/09/09","130376385","13174445","7796589240","399935665","8340075735"
"2021/09/08","199616815","70819620","10362988385","810088415","11443513235"
"2021/09/07","114521060","22187500","8407329955","434858855","8978897370"
"2021/09/06","19712560","168500","2755607495","319487150","3094975705"
"2021/09/03","77143790","8625370","4503645210","281786520","4871200890"
"2021/09/02","93356755","0","3502998450","290935395","3887290600"
"2021/09/01","26703185","0","1161625510","42251030","1230579725"
"2021/08/31","58733340","0","2729105545","203587470","2991426355"
"2021/08/30","77295055","354645","5565920165","703603870","6347173735"
"2021/08/27","190832785","0","4870745910","471902710","5533481405"
"2021/08/26","130036335","154175","5122506035","447865390","5700561935"
"2021/08/25","52219945","7225","596604235","93505295","742336700"
"2021/08/24","133329635","0","2576644665","376801040","3086775340"
"2021/08/23","23351815","0","462572250","81747680","567671745"
"2021/08/20","59186810","0","511528820","165525080","736240710"
"2021/08/19","35842385","0","596553125","152690455","785085965"
"2021/08/18","28835970",,"589502015","36586615","654924600"
"2021/08/17","42292055","27035940","904476985","248849330","1222654310"
"2021/08/13","36578615","0","616369535","222348355","875296505"
"2021/08/12","85354680",,"400134600","31835900","517325180"
"2021/08/11","1480","0","699857145","57456505","757315130"
"2021/08/10","23561660","987280","465829680","76168320","566546940"
"2021/08/09","155131360","0","909730995","109665340","1174527695"
"2021/08/06","26733540",,"342890005","19102490","388726035"
"2021/08/05","8335180","0","269602785","13201690","291139655"
"2021/08/04","16531670","0","249423180","6867910","272822760"
"2021/08/03","96094745",,"552340845","231651400","880086990"
"2021/08/02","6912135",,"553999380","23337420","584248935"
"2021/07/30","6588895",,"436766250","46004705","489359850"
"2021/07/29","41213435","14900","622461865","53406410","717096610"
"2021/07/28","38072590","0","739982220","54430085","832484895"
"2021/07/27","94543575","0","756854305","9803220","861201100"
"2021/07/26","44291165","0","343969155","128684950","516945270"
"2021/07/23","24960005","0","492183910","15659885","532803800"
"2021/07/22","21658935",,"512546670","58774145","592979750"
"2021/07/21","20203155","0","441317030","169384300","630904485"
"2021/07/20","45071170","0","653625480","60411355","759108005"
"2021/07/19","11694105",,"623702815","90641350","726038270"
"2021/07/16","21977570","0","877209565","12132245","911319380"
"2021/07/15","23762585",,"981336140","146547890","1151646615"
"2021/07/14","171346835","15950000","2904230695","65344190","3156871720"
"2021/07/13","106466855","0","1797518065","87878195","1991863115"
"2021/07/12","22989565","1670000","688557260","53736305","766953130"
"2021/07/09","45661455","16901170","1927982960","73833600","2064379185"
"2021/07/08","34645685","10453620","1690885105","32798545","1768782955"
"2021/07/07","4482015","67040935","808511640","7036175","887070765"
"2021/07/06","29639000","92878955","1226352925","27170725","1376041605"
"2021/07/05","63991735","9080000","1850957005","152512275","2076541015"
"2021/07/02","29104225","0","1625755140","67041785","1721901150"
"2021/07/01","192711015","57815","2718761040","643272945","3554802815"
"2021/06/30","223445555","187500","5283081640","264167145","5770881840"
"2021/06/29","44716755","0","1099636185","133049430","1277402370"
"2021/06/28","97760305",,"1574148575","151045770","1822954650"
"2021/06/25","25899750","0","1184161130","88766350","1298827230"
"2021/06/24","65441120","0","1438364695","16525530","1520331345"
"2021/06/23","70720615","0","1758567730","98527300","1927815645"
"2021/06/22","25249585",,"1046625855","7603665","1079479105"
"2021/06/21","66331450","0","1380912650","50554675","1497798775"
"2021/06/18","52552035","9050000","1966283695","234593380","2262479110"
"2021/06/17","60159805","937500","2722530115","353066815","3136694235"
"2021/06/16","33746060","0","1317333440","56158620","1407238120"
"2021/06/15","49902150",,"1332145685","25331810","1407379645"
"2021/06/14","23192480","0","1408570695","41525180","1473288355"
"2021/06/11","44446215","0","1787529345","39526930","1871502490"
"2021/06/10","95366435",,"1828332460","143738855","2067437750"
"2021/06/09","67032315",,"2105011495","109375645","2281419455"
"2021/06/08","31448820","20457365","3503737240","153406360","3709049785"
"2021/06/07","67055975","55570600","3173596845","115047825","3411271245"
"2021/06/04","126076100","36435000","2127682365","34421480","2324614945"
"2021/06/03","447472645","3830000","3216580875","259466535","3927350055"
"2021/06/02","206835480","0","6110942315","302027475","6619805270"
"2021/06/01","450850775","51813850","16880653380","749888920","18133206925"
"2021/05/31","726559585","591692745","23337463945","1193414170","25849130445"
"2021/05/28","199766380","156800","4231039690","245478380","4676441250"
"2021/05/27","989573595","648434470","14175612610","923758455","16737379130"
"2021/05/26","90110800","0","2443937635","97678095","2631726530"
"2021/05/25","88855450","2868440","1553596645","205434090","1850754625"
"2021/05/24","95030600","0","2499910900","277718015","2872659515"
"2021/05/21","411039480","52939425","6221636930","472484460","7158100295"
"2021/05/20","214130465","73547105","8950921525","656316265","9894915360"
"2021/05/18","356850080","2708850","9549460575","668984840","10578004345"
"2021/05/17","272250575","86470330","13328939615","1249547420","14937207940"
"2021/05/14","142804430","5019000","1301333145","90745995","1539902570"
"2021/05/13","75750560","5065000","2909331010","450698520","3440845090"
"2021/05/12","101763765","2052500","1691985305","216221760","2012023330"
"2021/05/11","64079555","1005000","846712330","42872465","954669350"
"2021/05/10","114998670","46815540","1006028415","67043590","1234886215"
"2021/05/07","24089710","0","736017765","40087380","800194855"
"2021/05/06","6134195","0","597419050","81904510","685457755"
"2021/05/04","81405395","9450000","1369043305","182810655","1642709355"
"2021/05/03","49256510","0","1185747645","173955425","1408959580"
"2021/04/30","67643795","0","1973010915","374534155","2415188865"
"2021/04/29","83695405","30810450","3240052430","298812820","3653371105"
"2021/04/28","89297005","0","2107889615","202802030","2399988650"
"2021/04/27","57526535","0","1771176235","186800765","2015503535"
"2021/04/26","83311730","0","3936788450","209344670","4229444850"
"2021/04/23","38871620","657000","1862877560","140387690","2042793870"
"2021/04/22","68495450","1395200","2136344005","117902495","2324137150"
"2021/04/21","257590230","35067500","9401141170","920161890","10613960790"
"2021/04/20","533091845","4718925","2371033070","155272185","3064116025"
"2021/04/19","300716510","20959805","5035367580","731921035","6088964930"
"2021/04/16","211334665","67185140","10734590670","701982255","11715092730"
"2021/04/15","765993090","18841680","9723186340","645632145","11153653255"
"2021/04/14","179271445","13995475","6843376005","450854585","7487497510"
"2021/04/13","537343625","0","7667428160","420913790","8625685575"
"2021/04/12","317281055","439073550","26092276280","1543182550","28391813435"
"2021/04/09","357657400","467838640","30496858200","909912320","32232266560"
"2021/04/08","185638725","91837500","11002160355","776136155","12055772735"
"2021/04/07","138517930","252380920","10013930980","361119320","10765949150"
"2021/04/06","157776635","20419045","9763256180","530825020","10472276880"
"2021/04/05","380474660","832394395","29504668340","1812222410","32529759805"
"2021/04/02","161675785","78587705","4819248570","701430355","5760942415"
"2021/04/01","69649920","631000","1779030080","80455085","1929766085"
"2021/03/31","35039690","0","1199897790","89588420","1324525900"
"2021/03/30","11164670","0","496199260","122905520","630269450"
"2021/03/29","19929780","0","1085376840","212954015","1318260635"
"2021/03/26","2605410","0","476977140","29906885","509489435"
"2021/03/25","874845","0","565476675","24072070","590423590"
"2021/03/24","73189660","0","864485645","120184445","1057859750"
"2021/03/23","117325950","0","1918744950","474818515","2510889415"
"2021/03/22","5826380","0","355015230","76413955","437255565"
"2021/03/19","59484900","0","297258650","44986660","401730210"
"2021/03/18","368070","0","489957195","59266195","549591460"
"2021/03/17","9205000","0","547974105","153968790","711147895"
"2021/03/16","40849140","12488615","1507409335","250137610","1810884700"
"2021/03/15","32343660","0","826516950","179610855","1038471465"
"2021/03/12","31016905","32040","523779795","165515435","720344175"
"2021/03/11","14298190","9148060","654477820","173243500","851167570"
"2021/03/10","20111760","0","990709660","73366110","1084187530"
"2021/03/09","3134500","0","1049086930","161286720","1213508150"
"2021/03/08","3027925","4080000","630833945","99084655","737026525"
"2021/03/05","216734765","0","634125860","96351015","947211640"
"2021/03/04","38550550","5615500","593305690","101103395","738575135"
"2021/03/03","77950280","0","810917685","13739885","902607850"
"2021/03/02","24890410","0","1178287070","51030660","1254208140"
"2021/02/26","5588380","0","460351255","122960805","588900440"
"2021/02/25","224607780","4170","572987215","114787965","912387130"
"2021/02/24","85130175","0","951528670","201574990","1238233835"
"2021/02/23","45805595","0","1682555240","112472805","1840833640"
"2021/02/22","243909200","0","1739530160","236507260","2219946620"
"2021/02/19","1703835","188910","1682522095","171334150","1855748990"
"2021/02/18","4931800","78000","1398577565","133454095","1537041460"
"2021/02/17","18875810","0","1805688575","210548255","2035112640"
"2021/02/16","22965845","243750","3321357285","241117290","3585684170"
"2021/02/15","9538725","0","2636456290","332050985","2978046000"
"2021/02/10","4026475","0","1325375520","66162145","1395564140"
"2021/02/09","957765","0","1660210570","179643925","1840812260"
"2021/02/08","32843520","1875000","1612864970","105724790","1753308280"
"2021/02/05","162660","4397705","1674012055","137559755","1816132175"
"2021/02/04","16911655","0","1245935745","100210415","1363057815"
"2021/02/03","5825835","0","2655723775","254940865","2916490475"
"2021/02/02","6737615","0","1330633570","89579960","1426951145"
"2021/02/01","3893005","0","2287372180","120336185","2411601370"
"2021/01/29","6787790","0","3602826440","228292430","3837906660"
"2021/01/28","50201340","593751265","26031453735","772182235","27447588575"
"2021/01/27","2157345","0","2546633600","113930825","2662721770"
"2021/01/26","103642140","21983060","8825075840","472764905","9423465945"
"2021/01/25","268605855","588744915","21424883740","805247160","23087481670"
"2021/01/22","15559115","46549205","894141940","99028390","1055278650"
"2021/01/21","1434185","81836800","2669744750","308545485","3061561220"
"2021/01/20","16067175","0","1371007300","63814550","1450889025"
"2021/01/19","75067295","146296250","5459784580","736928235","6418076360"
"2021/01/18","33754855","385908365","5744321220","365820075","6529804515"
"2021/01/15","13226765","63661220","645365345","41109675","763363005"
"2021/01/14","228330","79728245","607638115","49904415","737499105"
"2021/01/13","182870","0","393066940","3791550","397041360"
"2021/01/12","8504115","0","319847935","30979875","359331925"
"2021/01/11","37388565","44184970","2181132290","365592680","2628298505"
"2021/01/08","12884825","0","754835015","23160825","790880665"
"2021/01/07","0","6551800","474891565","22593865","504037230"
"2021/01/06","988990","11805000","356607045","22343170","391744205"
"2021/01/05","0","15184875","504748675","44002130","563935680"
"2021/01/04","671985","0","519527280","44206015","564405280"
"2020/12/30","65093845","1325035","323545670","41279675","431244225"
"2020/12/29","1392055","5925000","359834830","13835125","380987010"
"2020/12/28","33537700","0","684844195","20937310","739319205"
"2020/12/24","184725","2144315500","264178870","14647860","2423326955"
"2020/12/23","838260","181750","594743715","32827205","628590930"
"2020/12/22","403285","0","974498350","41365150","1016266785"
"2020/12/21","3070195","0","702721000","3489990","709281185"
"2020/12/18","381365","8790000","846168015","59739295","915078675"
"2020/12/17","222320","13051500","1832988220","114990540","1961252580"
"2020/12/16","65967330","95855460","5112175625","341522530","5615520945"
"2020/12/15","21745565","0","523466700","20516690","565728955"
"2020/12/14","46916385","9419765","598652785","27743490","682732425"
"2020/12/11","32295150","14206320","462005860","17742155","526249485"
"2020/12/10","2043090","0","350057580","933325","353033995"
"2020/12/09","58650","0","287912015","2731785","290702450"
"2020/12/08","7552990","0","713731290","30201930","751486210"
"2020/12/07","11214210","3255000","603315000","28528710","646312920"
"2020/12/04","56608210","2210000","1825088365","121189140","2005095715"
"2020/12/03","669350","0","383058580","3039985","386767915"
"2020/12/02","143730","0","245923270","4234155","250301155"
"2020/12/01","229445","0","194272005","827505","195328955"
"2020/11/30","68480","5401760","295093730","6969650","307533620"
"2020/11/27","78725","21313575","171447200","0","192839500"
"2020/11/26","6349790","477300","214362695","3312080","224501865"
"2020/11/25","698225","0","874920695","17445100","893064020"
"2020/11/24","48850060","44656725","1514801390","84007545","1692315720"
"2020/11/23","72806610","0","1392518915","52044770","1517370295"
"2020/11/20","542770","0","162022780","29190850","191756400"
"2020/11/19","37160460","1075000","345537450","26382915","410155825"
"2020/11/18","241564585","0","690070660","44745560","976380805"
"2020/11/17","80378075","3235850","699683775","12284680","795582380"
"2020/11/16","189471900","0","1075466235","30376900","1295315035"
"2020/11/13","216033140","53492470","3489813305","79329955","3838668870"
"2020/11/12","1132099181","58750000","4660064114","46321743","5897235038"
"2020/11/11","36441391","54696649","3751614884","163244519","4005997443"
"2020/11/10","5891183","0","132208538","2910424","141010145"
"2020/11/09","21366","0","149012630","4778307","153812303"
"2020/11/06","12207","0","92939593","5617372","98569172"
"2020/11/05","25972","0","92851798","3044005","95921775"
"2020/11/04","584270","8008343","60792361","1531863","70916837"
"2020/11/03","2088293","0","80559879","309540","82957712"
"2020/11/02","1869740","0","94430425","0","96300165"
"2020/10/30","1628627","0","296028067","2142807","299799501"
"2020/10/29","12142499","0","324587688","2762750","339492937"
"2020/10/28","0","0","121339870","1033968","122373838"
"2020/10/27","8031671","0","94978498","2004184","105014353"
"2020/10/26","6556","743458","163524252","4851669","169125935"
"2020/10/23","238247","14513428","127743713","2185582","144680970"
"2020/10/22","2009730","0","40655490","691783","43357003"
"2020/10/21","2392489","48134907","125491448","3289094","179307938"
"2020/10/20","2084134","0","89274121","1559848","92918103"
"2020/10/19","11443","85341836","216284424","2026860","303664563"
"2020/10/16","2497078","0","532419951","19488418","554405447"
"2020/10/15","1583563","801990","378587186","19250451","400223190"
"2020/10/14","221047","0","86844531","1834968","88900546"
"2020/10/13","5523","0","130646047","4625648","135277218"
"2020/10/12","848897","0","208450488","14229492","223528877"
"2020/10/08","1546","0","105208027","988455","106198028"
"2020/10/07","2340","0","21568788","711820","22282948"
"2020/10/06","3897","0","36539151","6682425","43225473"
"2020/10/05","1497198","0","23502109","9841922","34841229"
"2020/09/29","10112","0","41550578","1518956","43079646"
"2020/09/28","3845","0","17596713","667952","18268510"
"2020/09/25","0","0","27813398","1012440","28825838"
"2020/09/24","2052941","0","43613821","2304451","47971213"
"2020/09/23","2026352","0","74652303","3436412","80115067"
"2020/09/22","0","780773","148261525","18718333","167760631"
"2020/09/21","777","0","186714277","3116532","189831586"
"2020/09/18","57577","0","61389511","392150","61839238"
"2020/09/17","1550","0","49040187","2649570","51691307"
"2020/09/16","4099099","69761163","129068303","1385849","204314414"
"2020/09/15","5224015","0","150462562","1886247","157572824"
"2020/09/14","3132","0","108418223","0","108421355"
"2020/09/11","6309","0","50320455","79000","50405764"
"2020/09/10","11026","0","80850750","2974801","83836577"
"2020/09/09","379301","789000","123890341","11863130","136921772"
"2020/09/08","3176588","0","137959856","3669229","144805673"
"2020/09/07","37728","0","163623788","3019021","166680537"
"2020/09/04","6867","0","130104195","3504652","133615714"
"2020/09/03","8382","761000","114324045","3111585","118205012"
"2020/09/02","12155","7600","74799372","1725093","76544220"
"2020/09/01","12899","0","210308071","11880818","222201788"
"2020/08/31","1510","0","80677300","5246303","85925113"
"2020/08/28","18735","0","54036646","748000","54803381"
"2020/08/27","3720","447000","62230760","0","62681480"
"2020/08/26","2996","0","45699272","2216365","47918633"
"2020/08/25","14707557",,"38470592","4608223","57786372"
"2020/08/24","5942","0","44656399","879656","45541997"
"2020/08/21","3770","0","149841040","593357","150438167"
"2020/08/20","5215","0","201683705","3320732","205009652"
"2020/08/19","2064167","3461901","88453469","2822285","96801822"
"2020/08/18","4826280","0","238022355","4471903","247320538"
"2020/08/14","6064","0","81116221","3147766","84270051"
"2020/08/13","6064","76200","86338576","4056954","90477794"
"2020/08/12","13608","0","59797950","2586452","62398010"
"2020/08/11","37592","0","50140714","354663","50532969"
"2020/08/10","120750","0","72409196","404278","72934224"
"2020/08/07","6040","0","67677821","1488262","69172123"
"2020/08/06","7568","0","21535384","0","21542952"
"2020/08/05","47474","755000","52846636","2639000","56288110"
"2020/08/04","854826","0","37009757","443250","38307833"
"2020/08/03","3537771","0","169566890","538984","173643645"
"2020/07/31","0","0","59010612","2123321","61133933"
"2020/07/30","27180","0","104379572","0","104406752"
"2020/07/29","75200","3015038","32316883","0","35407121"
"2020/07/28","754","751000","98651900","0","99403654"
"2020/07/27","757","0","122341944","0","122342701"
"2020/07/24","150282","1510000","77064144","263436","78987862"
"2020/07/23","1862090","0","58691491","0","60553581"
"2020/07/22","767","0","39974461","5424741","45399969"
"2020/07/21","2305","0","92062800","392700","92457805"
"2020/07/20","12258301","0","40246348","5982769","58487418"
"2020/07/17","615144","0","43336337","0","43951481"
"2020/07/16","28196","7810500","51883222","0","59721918"
"2020/07/15","1477232","0","63260312",,"64737544"
"2020/07/14","6419014","0","42112208",,"48531222"
"2020/07/13","19890","0","149334106","3835300","153189296"
"2020/07/10","12031194","0","1162356697","65989549","1240377440"
"2020/07/09","18518636","0","315878408","0","334397044"
"2020/07/08","1868213","0","29255590","0","31123803"
"2020/07/07","137368","0","56411209",,"56548577"
"2020/07/06","2146948","0","76580349",,"78727297"
"2020/07/03","3790","0","16059849",,"16063639"
"2020/07/02","2269","0","27647922","0","27650191"
"2020/07/01","59173","0","32101030","0","32160203"
"2020/06/30","6024","0","68135430",,"68141454"
"2020/06/29","1572993","0","108500431","0","110073424"
"2020/06/26","951273","0","30495880","0","31447153"
"2020/06/25","17388","0","54345916","2760320","57123624"
"2020/06/24","2025650","3028","70476590","0","72505268"
"2020/06/23","4560","0","16570136",,"16574696"
"2020/06/22","1524","0","39891982",,"39893506"
"2020/06/19","1522","0","47655341","666750","48323613"
"2020/06/18","2016333","0","44469944","0","46486277"
"2020/06/17","6072","342760","179889760","4225200","184463792"
"2020/06/16","3054271","0","217057124","598955","220710350"
"2020/06/15","6634453","0","118032305","3068000","127734758"
"2020/06/12","6131963","0","207033027","3248750","216413740"
"2020/06/11","7487822","2139000","120448012","0","130074834"
"2020/06/10","7119428","0","138219269","5054555","150393252"
"2020/06/09","16816","0","132951833","0","132968649"
"2020/06/08","8833","0","90642899","2920540","93572272"
"2020/06/05","90874",,"145251497","0","145342371"
"2020/06/04","37838","0","97431262","0","97469100"
"2020/06/03","1470904",,"146484632","1964052","149919588"
"2020/06/02","479820","0","129156705","3207102","132843627"
"2020/06/01","0","0","93215558","56448","93272006"
"2020/05/29","0","0","88718630","0","88718630"
"2020/05/28","4587184","0","189556697","3305684","197449565"
"2020/05/27","0","777257","92742788","10277301","103797346"
"2020/05/26","5581109","0","64012133","6772760","76366002"
"2020/05/25","0","0","30274782","4958866","35233648"
"2020/05/22","7790","0","82708345","10423975","93140110"
"2020/05/21","640510","2328000","159306758","2580294","164855562"
"2020/05/20","771","172800","71275828","208449","71657848"
"2020/05/19","373691","2394880","113037328","3506960","119312859"
"2020/05/18","190042","0","104530752","3663764","108384558"
"2020/05/15","15217743","0","125474770","9628708","150321221"
"2020/05/14","10462379","0","104834406","3059832","118356617"
"2020/05/13","144977","0","90340607","2570157","93055741"
"2020/05/12","26396","0","98104723","20481239","118612358"
"2020/05/11","23775","791000","114683724","11271116","126769615"
"2020/05/08","312822","0","119268135","4509297","124090254"
"2020/05/07","411077","0","96852553","4838775","102102405"
"2020/05/06","3950000","458200","143925993","8944005","157278198"
"2020/05/04","0","0","102965492","8118849","111084341"
"2020/04/29","8419496","0","281460109","9510010","299389615"
"2020/04/28","9296733","0","269153260","0","278449993"
"2020/04/27","120600","4961996","130528182","4703831","140314609"
"2020/04/24","34597","0","88932649","16731467","105698713"
"2020/04/23","4457356","0","91471612","4000108","99929076"
"2020/04/22","1803875","0","162867405","5992677","170663957"
"2020/04/21","9453050","987194","323860978","47326490","381627712"
"2020/04/20","2032833","0","139307531","3568986","144909350"
"2020/04/17","4487516","0","244700124","0","249187640"
"2020/04/16","792","0","364523448","8564472","373088712"
"2020/04/14","11869647","0","263276711","18358376","293504734"
"2020/04/13","4028518","0","187175457","8634882","199838857"
"2020/04/10","28339","356865","257421777","24198539","282005520"
"2020/04/09","9406006",,"162833803","8780443","181020252"
"2020/04/08","5591004","1770000","140390954","1586520","149338478"
"2020/04/07","3925000","0","156247873","17452515","177625388"
"2020/04/06","5129432","0","304309065","318595","309757092"
"2020/04/03","12205383","0","89466254","186733","101858370"
"2020/04/02","0","0","128665996","12042755","140708751"
"2020/04/01","4191365","0","196845289","7814485","208851139"
"2020/03/31","2405358","0","107102882","2636963","112145203"
"2020/03/30","7391002","0","93716596","2023456","103131054"
"2020/03/27","6649237","5409680","133387232","18492652","163938801"
"2020/03/26","26120162","0","123156555","18989666","168266383"
"2020/03/25","29649588","0","78821680","13128675","121599943"
"2020/03/24","16349916","1410","73568384","17974869","107894579"
"2020/03/23","8101698","27640691","151652580","25585406","212980375"
"2020/03/20","37187727","0","127204210","4104842","168496779"
"2020/03/19","0","0","639149060","63942507","703091567"
"2020/03/18","19329577","0","120687371","17862532","157879480"
"2020/03/17","7837206","0","177564633","42444742","227846581"
"2020/03/16","2809355","0","86743104","5018396","94570855"
"2020/03/13","91345851","1301897","524826025","97592327","715066100"
"2020/03/12","20348359","0","302291726","91645718","414285803"
"2020/03/11","29569116","0","277547866","40561058","347678040"
"2020/03/10","3225881","158672","143396355","54753888","201534796"
"2020/03/09","16967207","0","133102008","79583637","229652852"
"2020/03/06","5501988","6708000","142862982","32129016","187201986"
"2020/03/05","22118167","0","190817495","4374408","217310070"
"2020/03/04","13348856","2164080","121111390","19809136","156433462"
"2020/03/03","5835145","0","89714795","36662122","132212062"
"2020/03/02","14127541","850","156092589","64055684","234276664"
"2020/02/28","27225297","0","357660730","81880863","466766890"
"2020/02/27","26964337","0","165540556","31314834","223819727"
"2020/02/26","16226931","0","148288568","38514366","203029865"
"2020/02/25","23069918","0","144753199","16462140","184285257"
"2020/02/24","8686611","0","561908791","81955620","652551022"
"2020/02/21","12150685","1833762","292564365","39750233","346299045"
"2020/02/20","6926918","0","124942645","28564944","160434507"
"2020/02/19","529701","0","120351063","19461898","140342662"
"2020/02/18","2495488","0","107749025","2250154","112494667"
"2020/02/17","7178821","0","158119326","615832","165913979"
"2020/02/14","0","0","439399174","13098917","452498091"
"2020/02/13","17380021","0","240985506","12758094","271123621"
"2020/02/12","18351545","0","280419888","11579518","310350951"
"2020/02/11","8930716","11863365","306420426","29724347","356938854"
"2020/02/10","22285623","117547795","792807135","39453201","972093754"
"2020/02/07","329717","0","293384086","9465071","303178874"
"2020/02/06","12436250","0","150209746","13985905","176631901"
"2020/02/05","23671473","0","218940138","2924948","245536559"
"2020/02/04","20256116","0","128510466","12996329","161762911"
"2020/02/03","22795884","0","313665868","42110031","378571783"
"2020/01/31","31610942","0","348801477","20743824","401156243"
"2020/01/30","29600095","0","259496463","20757183","309853741"
"2020/01/29","8769347","0","145311218","36532613","190613178"
"2020/01/28","0","917000","528966755","43136570","573020325"
"2020/01/23","0","597307","123444656","12034357","136076320"
"2020/01/22","1828972","7409431","141416408","6045666","156700477"
"2020/01/21","1751098","928000","172602441","29150605","204432144"
"2020/01/20","21143438","18526378","362126890","17271167","419067873"
"2020/01/17","6103336","0","361571633","9174134","376849103"
"2020/01/16","25784833","17280078","1278131047","191086059","1512282017"
"2020/01/15","4593424","68787092","432049588","12739248","518169352"
"2020/01/14","13755350","4633320","295630108","25032169","339050947"
"2020/01/13","23727020","0","258690992","10780909","293198921"
"2020/01/10","13440656","0","246141616","25800956","285383228"
"2020/01/09","8578173","0","368399238","10798560","387775971"
"2020/01/08","24714246","0","718153062","37978085","780845393"
"2020/01/07","23213585","0","279016597","7714005","309944187"
"2020/01/06","30391544","5543598","510860487","25909713","572705342"
"2020/01/03","15903907","4180020","452539638","5281790","477905355"
"2020/01/02","0","9570000","344278202","17347921","371196123"
"2019/12/30","4118587","0","260825869","1533810","266478266"
"2019/12/27","38967557","0","930426809","6573058","975967424"
"2019/12/26","56186870","0","1248934687","15674614","1320796171"
"2019/12/24","0","0","440003774","10975048","450978822"
"2019/12/23","28371249","0","519671584","71849871","619892704"
"2019/12/20","15632164","0","786748751","57374720","859755635"
"2019/12/19","39422441","3059796","1911495002","19057194","1973034433"
"2019/12/18","26857125","1685100","1400979642","53404519","1482926386"
"2019/12/17","49606347","241406379","7108620202","404765415","7804398343"
"2019/12/16","0","0","145350053","0","145350053"
"2019/12/13","7650673","0","228058316","4107510","239816499"
"2019/12/12","30019548","0","1388821599","214325516","1633166663"
"2019/12/11","7903936","0","177347661","4196020","189447617"
"2019/12/10","3988398","31121592","194394660","1066960","230571610"
"2019/12/09","2789235","37270562","58594801","9650800","108305398"
"2019/12/06","18640884","37406338","368741410","2350188","427138820"
"2019/12/05","11872234","0","280065689","468203","292406126"
"2019/12/04","642200","0","152643535",,"153285735"
"2019/12/03","1836000","0","54358708","2013368","58208076"
"2019/12/02","4856591","9170000","81986989",,"96013580"
"2019/11/29","4133911","0","167829318","3746859","175710088"
"2019/11/28","1863920","0","194257668","1437386","197558974"
"2019/11/27","34003","0","103313852",,"103347855"
"2019/11/26","32655509","0","120243434","12908","152911851"
"2019/11/25","16046411","1838000","156363120","929","174248460"
"2019/11/22","184400","0","91072907","14829217","106086524"
"2019/11/21","19157856","0","360155708","408924","379722488"
"2019/11/20","13043552","0","230110575","375254","243529381"
"2019/11/19","26417853","0","191959816","4315200","222692869"
"2019/11/18","52970640","965016","239000031","32927440","325863127"
"2019/11/15","16123844","0","207782213","4594328","228500385"
"2019/11/14","129190179","0","540114689","7537766","676842634"
"2019/11/13","49637799","0","352114963","1443396","403196158"
"2019/11/12","6478000","4378116","232441332","19232944","262530392"
"2019/11/11","9242543","9191294","220760513","2094840","241289190"
"2019/11/08","6945827","9197000","164779960","2475486","183398273"
"2019/11/07","33939716","0","305534320","10426913","349900949"
"2019/11/06","6420614","4565000","99729327","0","110714941"
"2019/11/05","8009512","816631","237684852","0","246510995"
"2019/11/04","8471037","3773200","106679137","0","118923374"
"2019/11/01","4088101","0","157148057","1086324","162322482"
"2019/10/31","3782718","6404757","205888328","1585089","217660892"
"2019/10/30","24291844","0","880290168","54393234","958975246"
"2019/10/29","669780","2744368","106755214","794372","110963734"
"2019/10/28","0","2745000","82562875","2250233","87558108"
"2019/10/25","1308964","916004","87611937","2797235","92634140"
"2019/10/24","5395787","2747000","62665530","162486","70970803"
"2019/10/23","3042382","0","199448459","16362702","218853543"
"2019/10/22","8124326","918834","75347266",,"84390426"
"2019/10/21","1669878","0","120976732","16814965","139461575"
"2019/10/18","12694894","0","145102635","27253478","185051007"
"2019/10/17","33363783","0","544766153","2229494","580359430"
"2019/10/16","4020478","0","62558687","8438648","75017813"
"2019/10/15","42554644","0","314754938","3552814","360862396"
"2019/10/14","6223062","0","38116987","3878741","48218790"
"2019/10/11","22149566","0","115407123","5169705","142726394"
"2019/10/10","3990984","0","97006890","17029516","118027390"
"2019/10/08","19185020","0","65023105","2932351","87140476"
"2019/10/07","8898498","1812","53180830","9275456","71356596"
"2019/10/04","7905029","0","52386419","130359","60421807"
"2019/10/02","814500","0","49000778","5952121","55767399"
"2019/10/01","4190258","0","111456347","14946421","130593026"
"2019/09/30","3955420","0","84831226","6381","88793027"
"2019/09/27","3428044","0","58838937","6567331","68834312"
"2019/09/26","456536","0","129906170","1257640","131620346"
"2019/09/25","11135179","910000","101487784","14054964","127587927"
"2019/09/24","6233872","917998","69336054","12870496","89358420"
"2019/09/23","4727927","916000","87478289","17163230","110285446"
"2019/09/20","13785824","0","140792130","1872946","156450900"
"2019/09/19","5108235","0","127049143","9103395","141260773"
"2019/09/18","33055635","0","154346990","13942741","201345366"
"2019/09/17","46629736","0","948943595","9743667","1005316998"
"2019/09/16","37155923","0","196873734","3735814","237765471"
"2019/09/11","9185411","0","233338304","28274888","270798603"
"2019/09/10","133454130","18782616","9416989315","62644927","9631870988"
"2019/09/09","7812144","19677384","665505945","16068878","709064351"
"2019/09/06","11584105","0","152969616","13737217","178290938"
"2019/09/05","4307219","0","503082081","54943881","562333181"
"2019/09/04","20205221","0","69121970","8525895","97853086"
"2019/09/03","11266408","0","199756751","3921718","214944877"
"2019/09/02","18433817","0","70847316","3349142","92630275"
"2019/08/30","18477729","0","73427535","8739966","100645230"
"2019/08/29","26828483","0","132078250","29475093","188381826"
"2019/08/28","22311675","0","88950133","10707643","121969451"
"2019/08/27","13025460","0","36750097","10351704","60127261"
"2019/08/26","236368","0","45730129","12772213","58738710"
"2019/08/23","32830869","0","584784775","55051115","672666759"
"2019/08/22","24506786","877000","213593394","5150868","244128048"
"2019/08/21","12052830","909460","259396407","20261764","292620461"
"2019/08/20","28038519","893000","530165661","61697951","620795131"
"2019/08/19","35756106","0","538277738","58429013","632462857"
"2019/08/16","11828106","0","92030583","14951350","118810039"
"2019/08/14","4062658",,"23380900","5245877","32689435"
"2019/08/13","9525449","0","42249152","8443002","60217603"
"2019/08/12","17178423",,"71502285","5778307","94459015"
"2019/08/09","5848007","0","52815116","15035084","73698207"
"2019/08/08","6767718","0","71990553","7628994","86387265"
"2019/08/07","24878374","0","122932628","15493839","163304841"
"2019/08/06","1826899","0","139223532","19841760","160892191"
"2019/08/05","13292420","0","307355662","13627139","334275221"
"2019/08/02","2488209","0","60093620","32571878","95153707"
"2019/08/01","12507543","0","73664103","17339134","103510780"
"2019/07/31","7027273","0","68174089","10952125","86153487"
"2019/07/30","14921808","0","167072073","10796580","192790461"
"2019/07/29","10439","447000","284637835","31681205","316776479"
"2019/07/26","433650","0","76500267","20017528","96951445"
"2019/07/25","0","0","145343103","19770169","165113272"
"2019/07/24","5825838","0","94400541","17096250","117322629"
"2019/07/23","10590684","0","73356998","6428518","90376200"
"2019/07/22","11500401","0","92932356","3392653","107825410"
"2019/07/19","396000","0","142013882","3477214","145887096"
"2019/07/18","493008","0","78826969","14276947","93596924"
"2019/07/17","15298306","162652","463889412","90057180","569407550"
"2019/07/16","1804","0","88602141","9379518","97983463"
"2019/07/15","7623204","0","47659343","6714643","61997190"
"2019/07/12","4550827","29280","127550894","257390","132388391"
"2019/07/11","4006220","29085","44917855","7405910","56359070"
"2019/07/10","968676","0","66515889","7854440","75339005"
"2019/07/09","10195010","172520","168814667","35632480","214814677"
"2019/07/08","0","173660","190499585","2749236","193422481"
"2019/07/05","4686687","0","189412462","3207830","197306979"
"2019/07/04","0","0","141226412","9851074","151077486"
"2019/07/03","2633133","0","120307686","1966354","124907173"
"2019/07/02","672708","0","40338955","4150597","45162260"
"2019/07/01","12477734","0","122764209","4227327","139469270"
"2019/06/28","3111530","0","111335486","13060928","127507944"
"2019/06/27","25648","0","141824128","25755581","167605357"
"2019/06/26","10193312","0","110755618","2314296","123263226"
"2019/06/25","10832197","0","128883836","71980927","211696960"
"2019/06/24","6223594","0","136388087","0","142611681"
"2019/06/21","9429156","0","128699987","6989315","145118458"
"2019/06/20","0","0","192922867","3538276","196461143"
"2019/06/19","709316","0","67391553","1726756","69827625"
"2019/06/18","7708036","0","201141874","3470641","212320551"
"2019/06/17","11820502","0","179202007","2409847","193432356"
"2019/06/14","11239182","933","159986985","1312599","172539699"
"2019/06/13","0","0","120393113","18327345","138720458"
"2019/06/12","11808752","0","430553009","42676883","485038644"
"2019/06/11","0","0","134028308","3450786","137479094"
"2019/06/10","0","0","104986291","2443395","107429686"
"2019/06/07","5197218","0","135556793","2184795","142938806"
"2019/06/05","12324601","0","93641901","8415657","114382159"
"2019/06/04","0","0","257369906","17491867","274861773"
"2019/06/03","1030900","0","167372722","4341556","172745178"
"2019/05/31","4004880","0","216266247","1245240","221516367"
"2019/05/30","0","0","199021984","10267915","209289899"
"2019/05/29","0","0","112590570","17755186","130345756"
"2019/05/28","6367922","0","96964821","2908701","106241444"
"2019/05/27","2068881","0","60895262","2745","62966888"
"2019/05/24","4085996","909000","163801131","7702696","176498823"
"2019/05/23","5698915","0","155693880","23529788","184922583"
"2019/05/22","447602","0","137947438","6536670","144931710"
"2019/05/21","4018272","0","126747508","14006442","144772222"
"2019/05/20","10545458","0","155327960","16196429","182069847"
"2019/05/17","900738","0","146049477","29802461","176752676"
"2019/05/16","10497384","0","283633757","4243188","298374329"
"2019/05/15","3448740","0","103325438","9579768","116353946"
"2019/05/14","7019043","0","165487469","3734917","176241429"
"2019/05/13","4971710","0","128405564","3736799","137114073"
"2019/05/10","0","0","210727475","19471770","230199245"
"2019/05/09","2319713","0","406095549","38276649","446691911"
"2019/05/08","501660",,"107694344","4295510","112491514"
"2019/05/07","0","3496884","143435805","757390","147690079"
"2019/05/03","0",,"99911970","687816","100599786"
"2019/05/02","6078408","0","185446502","3297521","194822431"
"2019/04/30","9284775","0","205988319","17614302","232887396"
"2019/04/29","9116682","0","111905121","2546494","123568297"
"2019/04/26","50586895","548100","535426932","1578924","588140851"
"2019/04/25","3290500",,"217255120","32119802","252665422"
"2019/04/24","11939318","0","167275055","7463127","186677500"
"2019/04/23","15071697",,"495975380","20240342","531287419"
"2019/04/22","9771525",,"247078231","1280629","258130385"
"2019/04/19","7629510","0","265699255","16325157","289653922"
"2019/04/18","16447644","0","245362290","41153511","302963445"
"2019/04/17","21874634","840400","700407246","7266665","730388945"
"2019/04/16","0","0","299997111","16754302","316751413"
"2019/04/15","12709289","0","270992342","14894012","298595643"
"2019/04/12","25361","2817","247704869","21627174","269360221"
"2019/04/11","7683663","0","140238408","3736691","151658762"
"2019/04/10","15902642","0","161168084","1752634","178823360"
"2019/04/09","0","8671477","176051634","10838336","195561447"
"2019/04/08","3568271","284400","175599451","14444393","193896515"
"2019/04/05","11604356","0","182386699","14620978","208612033"
"2019/04/04","26591551","0","495452224","56427819","578471594"
"2019/04/03","11327476","0","194228665","1964307","207520448"
"2019/04/02","3020967","0","214585237","6761128","224367332"
"2019/04/01","4740919","0","213943322","8370","218692611"
"2019/03/29","30446261","0","210872496","9004892","250323649"
"2019/03/28","0","935175","211204504","10384250","222523929"
"2019/03/27","4861873","946580","198731541","7524516","212064510"
"2019/03/26","3989232","0","121994191","5947661","131931084"
"2019/03/25","5783602","0","205420661","29190482","240394745"
"2019/03/22","4659229","0","282014142","14216467","300889838"
"2019/03/21","11976912","0","264442235","22590006","299009153"
"2019/03/20","26420349","0","342369899","39641950","408432198"
"2019/03/19","8110793","0","211038571","14351177","233500541"
"2019/03/18","125236",,"182301743","6148674","188575653"
"2019/03/15","118218","0","324999503","53220626","378338347"
"2019/03/14","17007807","0","199567815","1120404","217696026"
"2019/03/13","15341339",,"129905462","9128851","154375652"
"2019/03/12","15857585","193000","217429094","7358934","240838613"
"2019/03/11","5017930",,"298120177","8797659","311935766"
"2019/03/08","41047268",,"305985905","39826601","386859774"
"2019/03/07","19021969",,"318853511","35708995","373584475"
"2019/03/06","5048875",,"220364600","12211416","237624891"
"2019/03/05","25389943","197000","251221436","11234192","288042571"
"2019/03/04","11531913",,"218873221","5614077","236019211"
"2019/02/28","4646000","0","1080609628","170300097","1255555725"
"2019/02/27","13831504",,"391796216","5318786","410946506"
"2019/02/26","16589886","540804","1182073710","94145445","1293349845"
"2019/02/25","18295485","0","1114103735","42879641","1175278861"
"2019/02/22","10875810","0","698971371","67549801","777396982"
"2019/02/21","80000",,"778198365","57438025","835716390"
"2019/02/20","0",,"439733235","32457455","472190690"
"2019/02/19","4517949",,"1207557139","53561920","1265637008"
"2019/02/18","0",,"853096675","19615525","872712200"
"2019/02/15","0","1060000","1054922900","82317365","1138300265"
"2019/02/14","0","1085000","728140060","119011365","848236425"
"2019/02/13","0","0","1379058790","89361905","1468420695"
"2019/02/12","4040220","0","698543120","131142430","833725770"
"2019/02/11","2031105",,"1219713035","20848405","1242592545"
"2019/02/08","8110840","0","775551355","11307500","794969695"
"2019/02/07","11312570",,"1412974215","63316820","1487603605"
"2019/02/01","0","0","869446055","46679665","916125720"
"2019/01/31","0","4363200","1347031825","63864900","1415259925"
"2019/01/30","8073650","4466485","1662019605","139618940","1814178680"
"2019/01/29","0","0","1598949515","49776505","1648726020"
"2019/01/28","4073095",,"1759221230","27579940","1790874265"
"2019/01/25","0",,"721891280","53321955","775213235"
"2019/01/24","0",,"425486260","17659360","443145620"
"2019/01/23","3730600","0","372138675","36190775","412060050"
"2019/01/22","0",,"1076172090","46719760","1122891850"
"2019/01/21","0","0","478610620","38187960","516798580"
"2019/01/18","0",,"618002830","45883490","663886320"
"2019/01/17","4053840",,"913591085","11860215","929505140"
"2019/01/16","12177215",,"1238689155","34000615","1284866985"
"2019/01/15","4065960",,"1050304000","41427595","1095797555"
"2019/01/14","4067820",,"1556667395","87367445","1648102660"
"2019/01/11","12233760","8750","951495630","21607650","985345790"
"2019/01/10","2777600","0","1316870625","45297640","1364945865"
"2019/01/09","253170","263863670","716920030","83464095","1064500965"
"2019/01/08","1001750","0","2739326475","163637455","2903965680"
"2019/01/07","1899540",,"3149535455","179518165","3330953160"
"2019/01/04","0",,"2004635505","68275360","2072910865"
"2019/01/03","0","0","838854325","64904620","903758945"
"2019/01/02","0",,"980184665","54192485","1034377150"