일자,기관 합계,기타법인,개인,외국인 합계,전체
"2023/05/04","109313350","0","56970110","8468460","174751920"
"2023/05/03","100027660","610700","229955940","22689790","353284090"
"2023/05/02","49397855","0","72837770","37104120","159339745"
"2023/04/28","64017010","0","124883195","6396330","195296535"
"2023/04/27","12668785","0","96901490","284875","109855150"
"2023/04/26","59514560","1002770","54618585","16136775","131272690"
"2023/04/25","77379245","3781870","65197860","474940","146833915"
"2023/04/24","55796695","0","143208900","15301500","214307095"
"2023/04/21","64565365","0","186410225","32949700","283925290"
"2023/04/20","76029500","0","75359220","9354610","160743330"
"2023/04/19","114644000","44184200","276168060","62986165","497982425"
"2023/04/18","77529195","1567800","281198745","64476995","424772735"
"2023/04/17","92568195","50358000","366943450","68882095","578751740"
"2023/04/14","99614920","39490525","434155700","121137170","694398315"
"2023/04/13","52295295","68825000","414167095","106526280","641813670"
"2023/04/12","98685855","5515470","522745590","51629090","678576005"
"2023/04/11","85557045","34795100","555356240","57939410","733647795"
"2023/04/10","62707100","0","274670565","9083080","346460745"
"2023/04/07","174872015","51380500","417423050","12269755","655945320"
"2023/04/06","180457505","69203510","514571320","13505140","777737475"
"2023/04/05","252339800","32263100","441218815","72403340","798225055"
"2023/04/04","148919925","2367480","77901860","65034925","294224190"
"2023/04/03","111865395","34838900","119731265","31620325","298055885"
"2023/03/31","122740210","8535225","122973475","58419235","312668145"
"2023/03/30","12649505","18338810","82061065","25452025","138501405"
"2023/03/29","32572615","17644950","91186030","16463105","157866700"
"2023/03/28","47964970","41139255","152389955","15744990","257239170"
"2023/03/27","112461640","36587150","182913655","2614865","334577310"
"2023/03/24","43294625","170875","75861490","46834985","166161975"
"2023/03/23","44200950","1136195","121908415","5181410","172426970"
"2023/03/22","52655705","1599440","102053035","10148000","166456180"
"2023/03/21","20045415","17319055","76067150","0","113431620"
"2023/03/20","54984605","514500","104686585","6516465","166702155"
"2023/03/17","66789035","0","95231635","54290825","216311495"
"2023/03/16","105326060","15684415","160966170","63635720","345612365"
"2023/03/15","221472910","51944415","549267065","58810980","881495370"
"2023/03/14","213809275","1780315","257045860","138321150","610956600"
"2023/03/13","512476765","67831440","787823370","164651425","1532783000"
"2023/03/10","212943505","8779165","223623065","7681655","453027390"
"2023/03/09","29218955","7421475","92375250","19297550","148313230"
"2023/03/08","77796365","315040","119230385","650230","197992020"
"2023/03/07","58928775","316360","214063965","60590255","333899355"
"2023/03/06","26031605","21569245","91052820","4719785","143373455"
"2023/03/03","53904810","9362825","131884830","86410","195238875"
"2023/03/02","71183575","7401375","75340670","2651995","156577615"
"2023/02/28","53354740","7338985","66472400","19456880","146623005"
"2023/02/27","60838245","488170","84701815","8238400","154266630"
"2023/02/24","80508835","89125","133319305","17492740","231410005"
"2023/02/23","73742970","6346280","158262930","15502340","253854520"
"2023/02/22","67518890","6619560","74577310","1345145","150060905"
"2023/02/21","78146790","0","188036875","20592925","286776590"
"2023/02/20","83005355","4068205","75669765","10964940","173708265"
"2023/02/17","136833170","3311360","110108490","9378500","259631520"
"2023/02/16","53179670","126531300","250570890","111045","430392905"
"2023/02/15","110262620","25757850","163801690","21093775","320915935"
"2023/02/14","93949945","292200","46551045","175310","140968500"
"2023/02/13","54176765","73000","61985810","10001190","126236765"
"2023/02/10","33318100","0","54766495","17487200","105571795"
"2023/02/09","140922795","0","168342900","5122845","314388540"
"2023/02/08","124776915","8239450","125511115","37665805","296193285"
"2023/02/07","146225505","4277695","332558965","25545585","508607750"
"2023/02/06","148629755","31896385","258276460","14794385","453596985"
"2023/02/03","170330325","2338810","336152865","5079045","513901045"
"2023/02/02","239570065","6334280","157022665","195951115","598878125"
"2023/02/01","193547115","774080","128632940","20765700","343719835"
"2023/01/31","166983150","666365","76768835","25051175","269469525"
"2023/01/30","183578885","1173525","100414480","16311405","301478295"
"2023/01/27","271369370","41382100","148840830","5251875","466844175"
"2023/01/26","277240175","39409150","240332305","0","556981630"
"2023/01/25","167971030","586920","245275295","17491415","431324660"
"2023/01/20","476583520","1188050","143646575","103440080","724858225"
"2023/01/19","405086340","820225","553289980","87680075","1046876620"
"2023/01/18","345705210","106629050","385582235","155964320","993880815"
"2023/01/17","526782080","21972475","325122260","11009145","884885960"
"2023/01/16","458891300","4190250","349164835","186615195","998861580"
"2023/01/13","93087780","0","158178020","7064160","258329960"
"2023/01/12","195680450","0","107647170","46139135","349466755"
"2023/01/11","211976000","0","45204090","4407280","261587370"
"2023/01/10","296887705","309760","86691875","36866255","420755595"
"2023/01/09","302179250","835980","230272130","816375","534103735"
"2023/01/06","210018745","0","243765265","79237450","533021460"
"2023/01/05","939855955","3550000","140471955","359999585","1443877495"
"2023/01/04","212404920","4710345","193252295","144162030","554529590"
"2023/01/03","154458390","961505","328526005","6772470","490718370"
"2023/01/02","129133425","1012845","149101140","17022695","296270105"
"2022/12/29","425334865","0","120833455","50969230","597137550"
"2022/12/28","341217665","669500","125260075","35704095","502851335"
"2022/12/27","533970485","65218775","195898000","66359130","861446390"
"2022/12/26","241254960","0","94069510","292930","335617400"
"2022/12/23","308294140","0","180897210","37682795","526874145"
"2022/12/22","391087915","82625000","83945160","171750455","729408530"
"2022/12/21","253317365","82430505","70025130","21100080","426873080"
"2022/12/20","260047165","80296500","316276705","13542290","670162660"
"2022/12/19","141559740","498750","93123980","17175105","252357575"
"2022/12/16","283487395","325000","133454425","86817590","504084410"
"2022/12/15","157593755","326500","290257975","65603565","513781795"
"2022/12/14","86484720","4999680","145444965","34802830","271732195"
"2022/12/13","161628080","483960","205170170","5407925","372690135"
"2022/12/12","76915905","486000","272022860","2424100","351848865"
"2022/12/09","66898810","0","218034760","4737990","289671560"
"2022/12/08","145282765","1350510","116866720","3918910","267418905"
"2022/12/07","152353950","0","401718760","63003585","617076295"
"2022/12/06","213531235","45646500","251501730","94287290","604966755"
"2022/12/05","157964580","30370450","364144490","127032170","679511690"
"2022/12/02","155562390","0","270392840","133811830","559767060"
"2022/12/01","123590260","0","434572590","379975805","938138655"
"2022/11/30","32978470","28320655","314250705","94558680","470108510"
"2022/11/29","61304680","67208155","298834005","139955080","567301920"
"2022/11/28","45599630","57159915","464078180","4087200","570924925"
"2022/11/25","66250820","0","162796820","124099650","353147290"
"2022/11/24","48645050","0","67910725","28213070","144768845"
"2022/11/23","47800200","0","163313980","50259190","261373370"
"2022/11/22","51178370","0","185360595","25609180","262148145"
"2022/11/21","67174990","6271300","229054325","8271545","310772160"
"2022/11/18","43248925","0","173548375","18573185","235370485"
"2022/11/17","366501315","11400545","309772830","21702755","709377445"
"2022/11/16","55610745","303360","385308045","26922000","468144150"
"2022/11/15","98041350","0","195985355","9721395","303748100"
"2022/11/14","61249315","0","678635470","61780970","801665755"
"2022/11/11","149630725","20895955","341820645","129900980","642248305"
"2022/11/10","67590680","1174445","262955705","58209215","389930045"
"2022/11/09","163341790","45744580","242846010","51783090","503715470"
"2022/11/08","28279075","0","323364030","24291035","375934140"
"2022/11/07","42746370","2377500","266876550","19555435","331555855"
"2022/11/04","71928580","599000","348536800","2532785","423597165"
"2022/11/03","572921905","5423500","307779705","128890420","1015015530"
"2022/11/02","1001804805","293000","304874720","71824210","1378796735"
"2022/11/01","35917780","739110","288576675","72185345","397418910"
"2022/10/31","148385885","70397405","474466040","16849375","710098705"
"2022/10/28","245843225","300765","332695065","89863380","668702435"
"2022/10/27","364857865","31757590","454213085","187026610","1037855150"
"2022/10/26","159748755","115161775","459965215","74283990","809159735"
"2022/10/25","403643720","254464320","374640430","120443510","1153191980"
"2022/10/24","358280690","155876945","502727240","56009575","1072894450"
"2022/10/21","157079145","98917520","672833190","42344625","971174480"
"2022/10/20","78804750","30921440","825731945","5441200","940899335"
"2022/10/19","263015710","917260","1226490790","97837575","1588261335"
"2022/10/18","220181910","25821265","628476045","91874540","966353760"
"2022/10/17","215667510","41982785","235634025","13043515","506327835"
"2022/10/14","95714250","28235015","305501395","30830185","460280845"
"2022/10/13","239604855","20616820","720793830","188477855","1169493360"
"2022/10/12","171308945","59393425","850790045","84600850","1166093265"
"2022/10/11","111603545","50924925","355078120","8584245","526190835"
"2022/10/07","74995880","13091720","104038125","14683540","206809265"
"2022/10/06","176072710","4478240","321757225","25983355","528291530"
"2022/10/05","77021145","2714130","119481350","4411045","203627670"
"2022/10/04","33403730","3289600","110051785","1163425","147908540"
"2022/09/30","64123945","0","135965040","1429645","201518630"
"2022/09/29","5324895","5542290","80519370","1543240","92929795"
"2022/09/28","49297500","16566915","72358035","11059410","149281860"
"2022/09/27","35089210","0","140508390","2551155","178148755"
"2022/09/26","104270915","32319175","237163165","64573470","438326725"
"2022/09/23","11780690","11367445","107113125","196065","130457325"
"2022/09/22","9954890","32768375","59037100","2868905","104629270"
"2022/09/21","20745115","11473425","16150120","28523685","76892345"
"2022/09/20","69018125","12349985","154998755","50202610","286569475"
"2022/09/19","1937970","12513510","18649205","52241525","85342210"
"2022/09/16","25658090","4998900","39038230","298821280","368516500"
"2022/09/15","14386445","0","31368955","4001765","49757165"
"2022/09/14","30376620","5131300","57500715","7707780","100716415"
"2022/09/13","17455445","442000","37064420","7416125","62377990"
"2022/09/08","14156335","0","41606080","5295630","61058045"
"2022/09/07","14977515","4400000","59908510","6404960","85690985"
"2022/09/06","17104435","957030","37493860","2369975","57925300"
"2022/09/05","29679330","16758585","62795435","131760","109365110"
"2022/09/02","26330505","40271690","95356230","13656030","175614455"
"2022/09/01","66638225","36407750","575261665","69109160","747416800"
"2022/08/31","17972190","9584895","32655590","6454580","66667255"
"2022/08/30","23272280","9000000","177471385","2135965","211879630"
"2022/08/29","15815610","5209500","181226230","135955","202387295"
"2022/08/26","97178385","23763500","208846540","24964190","354752615"
"2022/08/25","19170595","0","88524775","10763595","118458965"
"2022/08/24","52364400","2317875","66109795","18340","120810410"
"2022/08/23","20426235","9246480","25060210","4033330","58766255"
"2022/08/22","34570435","0","52738410","2456865","89765710"
"2022/08/19","33286065","0","17244520","7576775","58107360"
"2022/08/18","19086880","0","43235020","4444630","66766530"
"2022/08/17","23221080","0","34834995","4650","58060725"
"2022/08/16","110982985","0","115941530","6982265","233906780"
"2022/08/12","47308315","1644545","184182065","4474045","237608970"
"2022/08/11","42416225","0","170398735","3644640","216459600"
"2022/08/10","17967605","0","113340900","3144485","134452990"
"2022/08/09","62375620","0","154452810","24126170","240954600"
"2022/08/08","23175105","0","25001200","28035","48204340"
"2022/08/05","143459645","0","28679215","5256600","177395460"
"2022/08/04","62366150","0","39077170","11785275","113228595"
"2022/08/03","188649995","2242470","40659065","10719810","242271340"
"2022/08/02","107457405","695250","34102755","8766100","151021510"
"2022/08/01","211892980","0","37376875","16149470","265419325"
"2022/07/29","149484640","85811485","113445075","67743500","416484700"
"2022/07/28","42697240","657750","45235030","12730140","101320160"
"2022/07/27","34551895","4763500","137446580","10961680","187723655"
"2022/07/26","19534870","43970395","55043010","883395","119431670"
"2022/07/25","125434645","0","34795250","8690710","168920605"
"2022/07/22","133737135","12072550","245932465","4288070","396030220"
"2022/07/21","69392890","13161905","255936550","27067450","365558795"
"2022/07/20","30002505","11195060","220620275","10519660","272337500"
"2022/07/19","125767235","8303405","369353950","23564445","526989035"
"2022/07/18","53080315","19267005","68869825","18076355","159293500"
"2022/07/15","109766715","198825","157708805","6475500","274149845"
"2022/07/14","27945390",,"53924195","2450270","84319855"
"2022/07/13","54075980","5370000","24169605","7907250","91522835"
"2022/07/12","61685305","6826375","108742310","2555825","179809815"
"2022/07/11","30142710","34579320","97805550","40610","162568190"
"2022/07/08","22772185","73144305","69583290","21819505","187319285"
"2022/07/07","62100230","27288370","46470565","3043155","138902320"
"2022/07/06","72965450","2726000","103909530","4760910","184361890"
"2022/07/05","101558415","11285705","194311800","19812790","326968710"
"2022/07/04","143543205","52839870","1252263350","361129720","1809776145"
"2022/07/01","151957385","19165000","405964270","37918235","615004890"
"2022/06/30","69267385","9842635","225271455","3964070","308345545"
"2022/06/29","140782210","1011675","310109770","41537775","493441430"
"2022/06/28","144645640","25000","242020850","21074100","407765590"
"2022/06/27","72015035","34433730","153577805","15562935","275589505"
"2022/06/24","73694720","27028730","317694370","32580140","450997960"
"2022/06/23","214193045","17023500","440705140","18373640","690295325"
"2022/06/22","198809210","34515150","656483370","12691100","902498830"
"2022/06/21","24890210","165006380","464320770","5063950","659281310"
"2022/06/20","93301560","1299000","456977540","346194250","897772350"
"2022/06/17","274697630","10425000","338912300","1414329530","2038364460"
"2022/06/16","88224660","158500","114335030","90187880","292906070"
"2022/06/15","242493650","7895000","198758590","102139750","551286990"
"2022/06/14","251524070","19241000","502751140","142832790","916349000"
"2022/06/13","107356350","27272900","221198970","105630160","461458380"
"2022/06/10","95546160","0","416379190","94811890","606737240"
"2022/06/09","37085540","0","89605860","63530840","190222240"
"2022/06/08","151903330","0","108373390","104221430","364498150"
"2022/06/07","173132860","0","209195720","127580570","509909150"
"2022/06/03","227559110","0","120755410","46196180","394510700"
"2022/06/02","95531970","0","192929140","98498300","386959410"
"2022/05/31","104836650","0","499868340","73538350","678243340"
"2022/05/30","263412810","49888800","398939800","73384450","785625860"
"2022/05/27","174335520","0","342654100","51391350","568380970"
"2022/05/26","148784200","10636550","189141530","1582400","350144680"
"2022/05/25","226718040","26400","659288330","41669540","927702310"
"2022/05/24","267039230","607300","170011550","7348970","445007050"
"2022/05/23","51372380","79450","78256880","0","129708710"
"2022/05/20","164553260","2061100","220945490","30269120","417828970"
"2022/05/19","25321610","59745580","163320980","2408390","250796560"
"2022/05/18","730930570","43265500","1542986470","29242850","2346425390"
"2022/05/17","88615920","2711850","71680060","139820","163147650"
"2022/05/16","142467440","5396800","25141360","6900450","179906050"
"2022/05/13","180365730","5367790","39096380","921890","225751790"
"2022/05/12","288739170","10690","104299450","1459320","394508630"
"2022/05/11","246800130","5330000","55281540","260680","307672350"
"2022/05/10","112128170","16937000","413893060","17737340","560695570"
"2022/05/09","35250030","0","212608880","14460080","262318990"
"2022/05/06","267080940","29601500","54390060","31984800","383057300"
"2022/05/04","151315530","13078500","196744760","4299370","365438160"
"2022/05/03","292531140","18927000","972267900","108987250","1392713290"
"2022/05/02","381956530","0","312561400","7226700","701744630"
"2022/04/29","109063000","0","290429820","0","399492820"
"2022/04/28","230852920","17034720","199584640","393840","447866120"
"2022/04/27","415798520","7255770","496454410","25290340","944799040"
"2022/04/26","625699150","40970500","194256680","26715040","887641370"
"2022/04/25","359861600","957000","169700810","3712530","534231940"
"2022/04/22","295714730","5480","107720520","3118200","406558930"
"2022/04/21","333565170","0","127070670","3653470","464289310"
"2022/04/20","530053660","0","76865940","13507840","620427440"
"2022/04/19","296854650","1625000","268313280","3502330","570295260"
"2022/04/18","562686110","813000","522742260","2305040","1088546410"
"2022/04/15","1630583450","0","557501200","220667270","2408751920"
"2022/04/14","599122890","5450000","128019070","6893420","739485380"
"2022/04/13","1133095210","0","189259890","109277090","1431632190"
"2022/04/12","376976370","26328320","358813000","1750080","763867770"
"2022/04/11","232298530","2685000","186805870","754310","422543710"
"2022/04/08","447717630","10525140","343534620","19287520","821064910"
"2022/04/07","242315360","0","98724500","782560","341822420"
"2022/04/06","337543420","61525000","148814830","5493910","553377160"
"2022/04/05","493758660","94057300","327689910","235860","915741730"
"2022/04/04","290164400","0","288906840","17961370","597032610"
"2022/04/01","618878960","106600000","389194250","29269430","1143942640"
"2022/03/31","537663900","4995480","325190440","176369980","1044219800"
"2022/03/30","240133380","0","334712100","31395710","606241190"
"2022/03/29","259861590","5230000","189313970","12507910","466913470"
"2022/03/28","265786950","9979300","123893670","5381490","405041410"
"2022/03/25","191078540","17003800","37374200","146720","245603260"
"2022/03/24","163464800","8886360","149841000","908310","323100470"
"2022/03/23","95512310","0","93481290","235620","189229220"
"2022/03/22","169470700","0","167235350","376570","337082620"
"2022/03/21","215801980","47881000","203473320","33036480","500192780"
"2022/03/18","260462630","20824420","329463470","291770","611042290"
"2022/03/17","96006920","20962300","186673210","83720","303726150"
"2022/03/16","109080380","26152200","102567530","5250","237805360"
"2022/03/15","159712940","4508260","115072470","15700","279309370"
"2022/03/14","192127030","878640","277334140","2668640","473008450"
"2022/03/11","141009090","0","172453710","5743490","319206290"
"2022/03/10","467026350","52500","184067670","2147710","653294230"
"2022/03/08","190564200","0","59098300","18898030","268560530"
"2022/03/07","295944240","1144100","314023060","4868170","615979570"
"2022/03/04","266343140","1100300","502632770","1571660","771647870"
"2022/03/03","798400000","4907400","66650980","64883040","934841420"
"2022/03/02","449330690","52000","216124870","5230","665512790"
"2022/02/28","291023100","0","64713040","5142820","360878960"
"2022/02/25","268742510","519000","106967820","11788400","388017730"
"2022/02/24","326567790","1319600","233515340","8128040","569530770"
"2022/02/23","236740010","2731000","97874970","192650","337538630"
"2022/02/22","304389430","7857700","212363740","4856800","529467670"
"2022/02/21","878530710","2615000","313913690","205100990","1400160390"
"2022/02/18","2638591500","18206700","267525430","171741660","3096065290"
"2022/02/17","275844080","0","101448500","12660930","389953510"
"2022/02/16","225821180","1026000","63164030","20701360","310712570"
"2022/02/15","185964800","0","65254660","4710090","255929550"
"2022/02/14","183916450","1022000","85557130","26925750","297421330"
"2022/02/11","195053050","5130000","129007370","66940","329257360"
"2022/02/10","157686870","10260000","204700210","8588820","381235900"
"2022/02/09","259496770","0","140210000","220230","399927000"
"2022/02/08","272890580","0","248317220","14468600","535676400"
"2022/02/07","232591180","20360000","197754500","40497630","491203310"
"2022/02/04","102236820","1078210","186531300","6369950","296216280"
"2022/02/03","331417950","0","170171750","54038390","555628090"
"2022/01/28","199503150","6064000","159844880","7949390","373361420"
"2022/01/27","227862460","14142000","384185950","21676320","647866730"
"2022/01/26","122053390","10180000","120846090","106910","253186390"
"2022/01/25","268661260","6485860","299557080","65251080","639955280"
"2022/01/24","214476590","1577200","163840620","3886230","383780640"
"2022/01/21","328235010","5130000","75369430","1159970","409894410"
"2022/01/20","235221110","2025070","123594810","5497900","366338890"
"2022/01/19","268385650","31046400","227754430","4847040","532033520"
"2022/01/18","297214490","10120000","85559510","40554610","433448610"
"2022/01/17","451397660","133166200","1093727740","4679600","1682971200"
"2022/01/14","358367660","21934300","1022821670","15330","1403138960"
"2022/01/13","267926820","10841350","782289300","314150","1061371620"
"2022/01/12","223177310","15480000","669071060","15157900","922886270"
"2022/01/11","597127640","20720","84698340","7521280","689367980"
"2022/01/10","452610660","46549050","389004260","22825640","910989610"
"2022/01/07","342041100","32037160","336217090","6055000","716350350"
"2022/01/06","238146390","52570240","231500240","114854250","637071120"
"2022/01/05","76220810","189705780","206394900","0","472321490"
"2022/01/04","522264120","22060500","230466410","5483570","780274600"
"2022/01/03","416789510","40133290","403129680","31000000","891052480"
"2021/12/30","21563890","42956200","926713900","6349220","997583210"
"2021/12/29","254198960","13872710","465223270","44671230","777966170"
"2021/12/28","408514440","0","1109783970","46645860","1564944270"
"2021/12/27","204737540","17708280","519966440","816750","743229010"
"2021/12/24","94282780","10460000","504266950","214550","609224280"
"2021/12/23","257476450","15700000","358541810","25958470","657676730"
"2021/12/22","226268930","4166000","494309200","402620","725146750"
"2021/12/21","1831442470","30317680","1235505620","422913880","3520179650"
"2021/12/20","2736421150","39946670","2610495610","210467530","5597330960"
"2021/12/17","110921110","0","219716450","25388080","356025640"
"2021/12/16","236936280","1000840","476622040","44461300","759020460"
"2021/12/15","160293400","10420000","737082310","44605040","952400750"
"2021/12/14","388445100","5190000","555958110","41339900","990933110"
"2021/12/13","156305640","58268120","563763250","52100","778389110"
"2021/12/10","76619740","129838600","867303520","47438790","1121200650"
"2021/12/09","169787910","58392240","712960560","219350","941360060"
"2021/12/08","250151320","207892240","620745830","24075080","1102864470"
"2021/12/07","52958970","191580310","515613720","109660","760262660"
"2021/12/06","423475350","124629740","875222710","151530","1423479330"
"2021/12/03","728239100","18280000","702802600","13666990","1462988690"
"2021/12/02","640753960","18350000","583007370","200822230","1442933560"
"2021/12/01","1028180350","77615000","962411220","280631360","2348837930"
"2021/11/30","913526830","57730000","4108881610","93085690","5173224130"
"2021/11/29","540225760","262294810","2733992650","117909690","3654422910"
"2021/11/26","1623196790","86130000","1591746030","440260","3301513080"
"2021/11/25","822207430","18626280","666736410","19297340","1526867460"
"2021/11/24","1423599980","151732810","1663840240","99940120","3339113150"
"2021/11/23","283375270","495403380","1296929900","166220","2075874770"
"2021/11/22","1819674100","332992440","2740886570","18910600","4912463710"
"2021/11/19","1606434230","287121310","4453858910","5288300","6352702750"
"2021/11/18","9678939490","2213486620","67463990420","11668006370","91024422900"