일자,기관 합계,기타법인,개인,외국인 합계,전체
"2023/05/04","121076940","127820","231718620","109414130","462337510"
"2023/05/03","202289720","5800","146086460","225089280","573471260"
"2023/05/02","295852580","2012770","314015520","33307860","645188730"
"2023/04/28","531729730","2711540","404798260","167967840","1107207370"
"2023/04/27","142177330","29240180","313909790","165527750","650855050"
"2023/04/26","277097660","103183280","418949000","192227060","991457000"
"2023/04/25","565783260","455292890","429327500","950246760","2400650410"
"2023/04/24","399681420","14915500","495437140","15611360","925645420"
"2023/04/21","359866610","3907000","430816050","49327670","843917330"
"2023/04/20","346245280","0","351910220","214601420","912756920"
"2023/04/19","469521280","314720","1197052460","87716770","1754605230"
"2023/04/18","608149610","63583180","549098120","881057840","2101888750"
"2023/04/17","1004328390","17068590","1098878900","1139814170","3260090050"
"2023/04/14","485445030","63054160","905484550","703851170","2157834910"
"2023/04/13","503336190","6601500","665133470","340443460","1515514620"
"2023/04/12","382438040","0","402293700","608526710","1393258450"
"2023/04/11","793843690","1614000","880961210","544742060","2221160960"
"2023/04/10","762810600","253426830","802198170","749984520","2568420120"
"2023/04/07","731664190","23498920","941101140","204685420","1900949670"
"2023/04/06","574995950","149073390","1080527570","134244970","1938841880"
"2023/04/05","212084560","42523000","475187340","91348650","821143550"
"2023/04/04","103166350","60337130","304906870","9634670","478045020"
"2023/04/03","174723920","11932520","407178150","343489660","937324250"
"2023/03/31","175619360","1667470","347197340","42557050","567041220"
"2023/03/30","393234990","9193050","1055379590","88459840","1546267470"
"2023/03/29","398016300","5593150","385225760","67118750","855953960"
"2023/03/28","149985260","8123660","534487740","25175450","717772110"
"2023/03/27","198210850","7127490","578182310","85097010","868617660"
"2023/03/24","199393940","17952630","495048940","134314170","846709680"
"2023/03/23","162377410","31909710","407719920","48285870","650292910"
"2023/03/22","170126980","16952620","601930690","25940350","814950640"
"2023/03/21","61363880","9752280","191663800","19970870","282750830"
"2023/03/20","234338920","37639300","639907370","20660970","932546560"
"2023/03/17","144733900","27024020","358244930","782729180","1312732030"
"2023/03/16","365790080","12780","169293850","27265970","562362680"
"2023/03/15","366369130","314580","256983120","76433520","700100350"
"2023/03/14","259773590","6490","130941360","83268690","473990130"
"2023/03/13","160595500","0","128791690","28578620","317965810"
"2023/03/10","208174730","0","147541840","96742810","452459380"
"2023/03/09","46824430","121390","135067020","19611940","201624780"
"2023/03/08","206847610","2409200","388337940","28020320","625615070"
"2023/03/07","292900530","4574230","436643750","29161920","763280430"
"2023/03/06","256545480","6498500","338273710","3814020","605131710"
"2023/03/03","651085430","16037790","606665970","186226910","1460016100"
"2023/03/02","184208600","13420","185872760","99579740","469674520"
"2023/02/28","130024170","6610","145492570","37036040","312559390"
"2023/02/27","64748720","1357960","213909460","18797630","298813770"
"2023/02/24","166076070","5834770","247083860","103126580","522121280"
"2023/02/23","70754550","0","461070430","121489180","653314160"
"2023/02/22","80263990","1333290","257422160","45951440","384970880"
"2023/02/21","86821190","2826730","300963710","2287320","392898950"
"2023/02/20","75525570","11178910","307734610","20490360","414929450"
"2023/02/17","147657960","20130","109356850","27745280","284780220"
"2023/02/16","190268420","3704150","249732920","156217400","599922890"
"2023/02/15","187216670","2825510","178839260","39298910","408180350"
"2023/02/14","149702090","2958550","176281800","12976730","341919170"
"2023/02/13","161753450","8400540","339703140","145663160","655520290"
"2023/02/10","126577360","4999060","185861010","22402210","339839640"
"2023/02/09","209927870","628360","280210840","95329550","586096620"
"2023/02/08","226760600","2180250","192219270","24548370","445708490"
"2023/02/07","208165980","6971760","205931150","52242490","473311380"
"2023/02/06","180529960","7010","155947520","63851280","400335770"
"2023/02/03","233870310","158990630","326702700","250920000","970483640"
"2023/02/02","361746260","54145890","60333920","47571720","523797790"
"2023/02/01","229633470","53134380","185475860","68848020","537091730"
"2023/01/31","194633030","0","164757830","167813900","527204760"
"2023/01/30","294472990","470580","181452620","115997060","592393250"
"2023/01/27","272283560","18390260","104729400","135020710","530423930"
"2023/01/26","303553390","79856000","102882930","45401020","531693340"
"2023/01/25","196578070","0","114357360","183626540","494561970"
"2023/01/20","259400080","723170","97882880","147938640","505944770"
"2023/01/19","157485480","284987010","50553700","4431660","497457850"
"2023/01/18","289763420","14010","87104690","128314930","505197050"
"2023/01/17","205187130","7000","77993150","3492380","286679660"
"2023/01/16","263584070","13960","107180530","117452260","488230820"
"2023/01/13","60474920","13810","164903910","18868680","244261320"
"2023/01/12","51706830","4171880","119371260","27727310","202977280"
"2023/01/11","70660100","20690","93169410","49495270","213345470"
"2023/01/10","169486910","20828250","173886240","122111150","486312550"
"2023/01/09","202242780","0","155103990","130744760","488091530"
"2023/01/06","189107320","7000","91499130","90625540","371238990"
"2023/01/05","260520030","368670","295279670","376383160","932551530"
"2023/01/04","124995970","1411408770","153503320","111087640","1800995700"
"2023/01/03","170010400","95444280","65095070","238587330","569137080"
"2023/01/02","205216130","69747260","55787490","303153780","633904660"
"2022/12/29","86837560","877830","51582220","32912120","172209730"
"2022/12/28","80616110","4818000","90508560","58838380","234781050"
"2022/12/27","145452870","0","139521380","3397010","288371260"
"2022/12/26","210953860","6610","93811010","10417930","315189410"
"2022/12/23","240669960","6550","78472810","68691330","387840650"
"2022/12/22","312736370","660530","209301370","116637000","639335270"
"2022/12/21","100317900","19580","82323160","122058560","304719200"
"2022/12/20","195933660","810470","128826330","51328170","376898630"
"2022/12/19","131769240","10178140","120094900","146993880","409036160"
"2022/12/16","303328360","676670","75379150","194043210","573427390"
"2022/12/15","188564550","158160","156870390","108140090","453733190"
"2022/12/14","233696030","19800","90075320","141202230","464993380"
"2022/12/13","39896770","4607070","164547380","41599900","250651120"
"2022/12/12","54769100","6659930","114038500","39858730","215326260"
"2022/12/09","412276590","6757020","123813860","26737160","569584630"
"2022/12/08","156221210","7305050","111243170","6837250","281606680"
"2022/12/07","117004640","0","87040010","5652140","209696790"
"2022/12/06","155346500","1081580","169452330","34165960","360046370"
"2022/12/05","196721020","2430690","152536920","57023070","408711700"
"2022/12/02","117789550","4071870","206413010","38044880","366319310"
"2022/12/01","142688850","342000","139540200","57588290","340159340"
"2022/11/30","45227870","19847510","99584430","73541650","238201460"
"2022/11/29","44624060","1311390","60651720","96320940","202908110"
"2022/11/28","359286420","8211820","240032940","50831310","658362490"
"2022/11/25","154167250","696920","101100420","15527190","271491780"
"2022/11/24","136811410","993600","167153640","130319360","435278010"
"2022/11/23","178415340","10885470","253350150","128492200","571143160"
"2022/11/22","167457430","894470","83947360","33549640","285848900"
"2022/11/21","147549320","303580","105447160","8893210","262193270"
"2022/11/18","192000150","299280","82861110","10638960","285799500"
"2022/11/17","179256870","718880","105856090","5267910","291099750"
"2022/11/16","264482200","14571860","214466760","41833080","535353900"
"2022/11/15","338914110","7010000","134445500","21106270","501475880"
"2022/11/14","165089610","1424000","88005890","114851620","369371120"
"2022/11/11","295058610","297360","218206360","398302050","911864380"
"2022/11/10","268863770","7079640","119495960","186710020","582149390"
"2022/11/09","182869160","225830","78826540","135928200","397849730"
"2022/11/08","166399440","3711300","143450310","24024800","337585850"
"2022/11/07","136527620","368727320","174751290","63260650","743266880"
"2022/11/04","252662860","13525170","146294640","162624140","575106810"
"2022/11/03","200905170","9128720","246563140","182015220","638612250"
"2022/11/02","677518460","13485770","940933710","524988290","2156926230"
"2022/11/01","397123270","10951040","313252740","90816230","812143280"
"2022/10/31","406043980","20740","274905410","723717480","1404687610"
"2022/10/28","28193820","2082000","187767290","182872490","400915600"
"2022/10/27","137965820","770500","150189980","82739880","371666180"
"2022/10/26","189759280","684520","118776850","175633880","484854530"
"2022/10/25","74377750","0","79463620","60157740","213999110"
"2022/10/24","63056340","27250","44159770","172444760","279688120"
"2022/10/21","324615700","1959000","171337570","175777680","673689950"
"2022/10/20","468934920","3909300","222275710","964373200","1659493130"
"2022/10/19","374305840","82560870","346129400","631354610","1434350720"
"2022/10/18","251579830","65485980","276251840","1034142370","1627460020"
"2022/10/17","155253600","14177780","592589250","697043380","1459064010"
"2022/10/14","212490700","664400","306651190","169398750","689205040"
"2022/10/13","638838490","8074520","525482300","362646420","1535041730"
"2022/10/12","208743920","822250","167574100","238176430","615316700"
"2022/10/11","164712810","21169470","359146640","278841520","823870440"
"2022/10/07","153385490","0","140787400","290239860","584412750"
"2022/10/06","185792010","27875640","190701460","24101420","428470530"
"2022/10/05","321629920","34616560","311968270","594108940","1262323690"
"2022/10/04","175784310","128820","125062060","177908320","478883510"
"2022/09/30","831989580","816200","319245170","332908340","1484959290"
"2022/09/29","389188590","53500630","230095380","48872760","721657360"
"2022/09/28","328766680","109045740","281009190","281649620","1000471230"
"2022/09/27","452195820","0","265887310","85807620","803890750"
"2022/09/26","883864280","122483520","397641650","139678130","1543667580"
"2022/09/23","300371750","100712350","118138370","96015710","615238180"
"2022/09/22","235406140","123462090","34236220","186741760","579846210"
"2022/09/21","82688500","113627450","171557140","40167640","408040730"
"2022/09/20","159285090","28444880","13078360","15380250","216188580"
"2022/09/19","636593670","118296490","95879580","165719300","1016489040"
"2022/09/16","440823410","7160940","606167360","11022056420","12076208130"
"2022/09/15","495146640","11171000","32298050","610193530","1148809220"
"2022/09/14","240701160","819050","558840260","776407590","1576768060"
"2022/09/13","71118670","16833750","59962620","1290349050","1438264090"
"2022/09/08","209687350","10126990","128488140","234717140","583019620"
"2022/09/07","243063220","6425540","101508700","328591820","679589280"
"2022/09/06","79304460","1589000","135082980","346278100","562254540"
"2022/09/05","30842760","1651230","60978860","146404410","239877260"
"2022/09/02","31019050","427750","105129770","177515630","314092200"
"2022/09/01","180461540","15538700","177181080","359203950","732385270"
"2022/08/31","148976580","79490000","96693310","366507210","691667100"
"2022/08/30","173442610","2607590","99709550","318754220","594513970"
"2022/08/29","176502520","5251650","209453450","268077990","659285610"
"2022/08/26","149595080","15900000","164315980","299986690","629797750"
"2022/08/25","335386950","0","179703580","283993550","799084080"
"2022/08/24","140705110","78178480","160702230","329585320","709171140"
"2022/08/23","167486140","78907870","101893000","575913530","924200540"
"2022/08/22","330276550","89594000","401767400","214437160","1036075110"
"2022/08/19","255123700","40708580","152533930","1122386670","1570752880"
"2022/08/18","143449940","77800000","307652340","1019763160","1548665440"
"2022/08/17","145851010","77623340","195932720","862191200","1281598270"
"2022/08/16","328657210","1780920","905201860","500325670","1735965660"
"2022/08/12","346589830","4660970","492161310","659665380","1503077490"
"2022/08/11","53553060","7457000","158240530","88600600","307851190"
"2022/08/10","71523930","1552000","41403560","68034760","182514250"
"2022/08/09","91556430","6232800","74941660","189814970","362545860"
"2022/08/08","216096530","8792660","306309390","257420080","788618660"
"2022/08/05","200654490","24962530","282945020","72659150","581221190"
"2022/08/04","319548550","23570","287909860","253657880","861139860"
"2022/08/03","332179620","54980","194573750","118628860","645437210"
"2022/08/02","139168950","7760000","222927970","457642470","827499390"
"2022/08/01","296782390","28958210","121968370","51398440","499107410"
"2022/07/29","232361550","82946240","208957980","237351210","761616980"
"2022/07/28","247783420","15135960","262578430","166312080","691809890"
"2022/07/27","313812390","997170","171728850","196953820","683492230"
"2022/07/26","222053840","77810000","30752190","97469220","428085250"
"2022/07/25","383590020","159549200","113686590","171826130","828651940"
"2022/07/22","560920460","4009810","179254180","551088400","1295272850"
"2022/07/21","624521280","470726480","96241710","417849690","1609339160"
"2022/07/20","558357800","328985160","148477150","635118650","1670938760"
"2022/07/19","234581800","8582560","51937810","461733310","756835480"
"2022/07/18","410582200","4591620","53692120","488565340","957431280"
"2022/07/15","156922250","772000","82398290","392196670","632289210"
"2022/07/14","21075400","0","54337560","94579790","169992750"
"2022/07/13","95943570","7720","112982750","358247110","567181150"
"2022/07/12","147611690","184320","108175120","179643380","435614510"
"2022/07/11","141623500","772000","95941410","241840170","480177080"
"2022/07/08","166878460","7790","55039780","123715650","345641680"
"2022/07/07","123925270","786760","90602760","72531950","287846740"
"2022/07/06","311859850","2310000","85099680","170989450","570258980"
"2022/07/05","354090930","8098800","332066060","203449460","897705250"
"2022/07/04","271661030","10378900","212049280","178477420","672566630"
"2022/07/01","309673580","1529640","58135900","120425380","489764500"
"2022/06/30","237492050","883140","206655140","203934200","648964530"
"2022/06/29","94859830","53461700","61533680","118688340","328543550"
"2022/06/28","749450410","66257080","45700380","183648770","1045056640"
"2022/06/27","654805950","63097350","157061640","266875020","1141839960"
"2022/06/24","670264640","54025790","207910750","391882210","1324083390"
"2022/06/23","1268379900","61365440","421163040","725872870","2476781250"
"2022/06/22","432927320","7570000","289941500","269820760","1000259580"
"2022/06/21","598613720","27495200","367504160","264902060","1258515140"
"2022/06/20","631364240","243909790","493335080","364526330","1733135440"
"2022/06/17","598515300","144600940","519863930","127897030","1390877200"
"2022/06/16","225389970",,"164539060","135106810","525035840"
"2022/06/15","376870800","6849770","286676760","29625170","700022500"
"2022/06/14","435986770","15710","253230390","113823290","803056160"
"2022/06/13","385941030","9682060","183749150","228251830","807624070"
"2022/06/10","281859700","0","73585760","52954470","408399930"
"2022/06/09","192339970","5600020","90258340","38278040","326476370"
"2022/06/08","307011960","4858330","110495400","95098820","517464510"
"2022/06/07","635511560","8075200","261856600","220162310","1125605670"
"2022/06/03","759705870","72040","185073800","157280010","1102131720"
"2022/06/02","862576160","0","365198050","158641810","1386416020"
"2022/05/31","677350740","8013640","254858410","381784700","1322007490"
"2022/05/30","586171180","10475110","258658330","93720820","949025440"
"2022/05/27","633714780","7950","243024720","56586340","933333790"
"2022/05/26","1419369570","103130","160726110","196762330","1776961140"
"2022/05/25","1304047550","71319550","336248140","128552890","1840168130"
"2022/05/24","904492700","0","51753180","230935260","1187181140"
"2022/05/23","468885780","0","37197270","116458280","622541330"
"2022/05/20","1892946030","36622470","197139960","457904660","2584613120"
"2022/05/19","1017800150","7671000","134859440","57999640","1218330230"
"2022/05/18","654025800","24013680","175263950","116157070","969460500"
"2022/05/17","1166867260","38373960","517863480","24842030","1747946730"
"2022/05/16","713003000","746870","208670020","66887620","989307510"
"2022/05/13","1639587880","17036230","332425750","28957190","2018007050"
"2022/05/12","892014520","23260","107948730","81598760","1081585270"
"2022/05/11","848841390","161830","148123820","173463600","1170590640"
"2022/05/10","1014384240","30285520","288745630","251286650","1584702040"
"2022/05/09","423547380","23105220","437158750","165382940","1049194290"
"2022/05/06","395015120","23381300","517316940","206868650","1142582010"
"2022/05/04","450290450","41638810","302046010","212063110","1006038380"
"2022/05/03","827398180","23507890","685202450","455493980","1991602500"
"2022/05/02","954173360","15916090","637049220","342856120","1949994790"
"2022/04/29","1690914700","56449200","172677790","385293210","2305334900"
"2022/04/28","1822832240","39431560","1009318470","151085440","3022667710"
"2022/04/27","1145941240","5963310","233515360","362262940","1747682850"
"2022/04/26","1213948570","79200000","898966690","6574352148","8766467408"
"2022/04/25","581319240","0","163055390","366367330","1110741960"
"2022/04/22","411713710","0","156330590","352769140","920813440"
"2022/04/21","733224850","43866910","160048960","131740120","1068880840"
"2022/04/20","900768520","7930","81421100","435937580","1418135130"
"2022/04/19","509487570","0","117330790","157647570","784465930"
"2022/04/18","578782910","0","336436510","109067010","1024286430"
"2022/04/15","1058516390","0","611696860","487667310","2157880560"
"2022/04/14","655632130","0","274016500","219649300","1149297930"
"2022/04/13","780997230","10007600","302856290","314434130","1408295250"
"2022/04/12","669552240","0","206886960","375106720","1251545920"
"2022/04/11","632549640","0","94932170","200061960","927543770"
"2022/04/08","531378010","25430750","245286250","99396700","901491710"
"2022/04/07","466863770","23145420","254250260","225734820","969994270"
"2022/04/06","1788586350","9130820","426491960","376732350","2600941480"
"2022/04/05","1772145520","14460720","348741820","634660060","2770008120"
"2022/04/04","1042770580","100339420","1781935090","1162861540","4087906630"
"2022/04/01","1155094440","97266280","545193890","286771080","2084325690"
"2022/03/31","1437593340","17806090","1282061790","656901330","3394362550"
"2022/03/30","1435617350","12811550","1107205860","1440333100","3995967860"
"2022/03/29","303655240","60386350","469760350","235165550","1068967490"
"2022/03/28","379128400","14971770","382525970","70825520","847451660"
"2022/03/25","928786360","30548450","815799660","239010160","2014144630"
"2022/03/24","318189100","90520460","370279130","125205500","904194190"
"2022/03/23","516829320","52170310","479921600","85946160","1134867390"
"2022/03/22","474074900","0","243444410","219880590","937399900"
"2022/03/21","211879530","28889530","181728420","30489060","452986540"
"2022/03/18","205650630","4722610","117094440","224288820","551756500"
"2022/03/17","203294820","28314900","304895080","25197990","561702790"
"2022/03/16","154388860","16049290","83715250","20743420","274896820"
"2022/03/15","486044010","3817100","136770120","127975730","754606960"
"2022/03/14","288406620","11402360","166655150","65065660","531529790"
"2022/03/11","344702610","43488260","215132340","62249040","665572250"
"2022/03/10","446190380","8966900","712462060","257361920","1424981260"
"2022/03/08","386748080","30194700","409264550","60148870","886356200"
"2022/03/07","253473520","19752800","428304680","52853250","754384250"
"2022/03/04","218877250","21288550","131522540","21559970","393248310"
"2022/03/03","1131991850","64850490","183744510","109921120","1490507970"
"2022/03/02","787011190","7940","274604130","110957450","1172580710"
"2022/02/28","654371900","62247470","416778430","234667660","1368065460"
"2022/02/25","136310070","17644000","144391880","54219120","352565070"
"2022/02/24","380682290","0","165361100","166245460","712288850"
"2022/02/23","119706280","160600","107341990","26633750","253842620"
"2022/02/22","2123303390","4000000","409716490","2606710","2539626590"
"2022/02/21","70028670","16030000","75066100","64247900","225372670"
"2022/02/18","178251670","94679270","335476590","46723950","655131480"
"2022/02/17","345087330","154719440","477555130","86944670","1064306570"
"2022/02/16","351642110","112133130","494865390","41689170","1000329800"
"2022/02/15","61607080","8090","254082600","57019500","372717270"
"2022/02/14","94271870","5832700","186502540","2684010","289291120"
"2022/02/11","378441350","104883770","338546620","99229630","921101370"
"2022/02/10","352253940","0","45662170","278115160","676031270"
"2022/02/09","219802700","0","200166400","86211380","506180480"
"2022/02/08","262194310","0","153697510","152656270","568548090"
"2022/02/07","212349510","0","53100860","73247480","338697850"
"2022/02/04","191172430","0","219313530","102751510","513237470"
"2022/02/03","251270590","19998970","264150510","231194500","766614570"
"2022/01/28","352479130","40045880","191166740","30684420","614376170"
"2022/01/27","806485010","53677190","712745700","277530040","1850437940"
"2022/01/26","301224940","14418000","25952500","67971090","409566530"
"2022/01/25","610600560","8366500","206112970","63237350","888317380"
"2022/01/24","276984230","56210","186568330","69348320","532957090"
"2022/01/21","171626910","861320","114338200","90776200","377602630"
"2022/01/20","276298070","0","12556570","40210","288894850"
"2022/01/19","306870850","0","69705560","59308460","435884870"
"2022/01/18","281601670","0","44155080","17441440","343198190"
"2022/01/17","228140910","0","65481720","15326330","308948960"
"2022/01/14","235333700","0","48288060","96803620","380425380"
"2022/01/13","266543260","695130","55178970","5888710","328306070"
"2022/01/12","142709850","28402140","23454720","45753170","240319880"
"2022/01/11","271586890","0","108345880","29171390","409104160"
"2022/01/10","437170490","62108330","155120370","52664650","707063840"
"2022/01/07","111267150","68469610","68915020","12911960","261563740"
"2022/01/06","320907670","33307340","53632240","59285100","467132350"
"2022/01/05","229621030","8099700","75207810","72788750","385717290"
"2022/01/04","551418580","7960000","97313920","192343210","849035710"
"2022/01/03","195162090","0","265218930","72693920","533074940"
"2021/12/30","256266180",,"153872130","109337510","519475820"
"2021/12/29","337398770","8000","147931970","125536590","610875330"
"2021/12/28","57350880","40050","256763290","861459610","1175613830"
"2021/12/27","27921990","0","166424600","89051770","283398360"
"2021/12/24","77224260","2045100","453404200","29220740","561894300"
"2021/12/23","156483950","27266440","252910860","118233230","554894480"
"2021/12/22","30164130","35890120","177223920","85745410","329023580"
"2021/12/21","330063180","7990","183992400","156633410","670696980"
"2021/12/20","424022240","75904600","245803970","54480900","800211710"
"2021/12/17","123240930","128180760","223618520","185264100","660304310"
"2021/12/16","82120800","748240","67712870","6918950","157500860"
"2021/12/15","41708860","20519890","88036280","4631380","154896410"
"2021/12/14","190966680",,"54750910","3795100","249512690"
"2021/12/13","165935250","0","46753480","1484440","214173170"
"2021/12/10","214259170","7940","316011860","57884260","588163230"
"2021/12/09","136273520","71010","427613780","25206980","589165290"
"2021/12/08","166872320","0","120330560","15880","287218760"
"2021/12/07","148679260","0","268527390","64884300","482090950"
"2021/12/06","160694510","1407980","179426330","16583130","358111950"
"2021/12/03","156019510","15900000","115069350","41944740","328933600"
"2021/12/02","253366390","5970000","62393500","33935010","355664900"
"2021/12/01","372294680","32378220","247851860","117178820","769703580"
"2021/11/30","395720930","12277000","317019930","14385000","739402860"
"2021/11/29","304257440","20036710","144910130","29532430","498736710"
"2021/11/26","174101520","40536380","204752580","28233720","447624200"
"2021/11/25","359187140","31702790","43940780","18827510","453658220"
"2021/11/24","157389980","16342560","279022080","23122940","475877560"
"2021/11/23","286317850",,"198579150","25725170","510622170"
"2021/11/22","157956280","240000","152357750","87870","310641900"
"2021/11/19","75927850",,"134826260","5935990","216690100"
"2021/11/18","111530410","0","163089830","45953220","320573460"
"2021/11/17","147849990",,"138187090","56070","286093150"
"2021/11/16","81769210","0","192740340","17092280","291601830"
"2021/11/15","172354360","8000","191293610","65503760","429159730"
"2021/11/12","102479870","103930","100164700","55105720","257854220"
"2021/11/11","156677910","0","242736520","55536170","454950600"
"2021/11/10","313074870","15940","129755210","1012670","443858690"
"2021/11/09","205763480","23850000","177232830","8929520","415775830"
"2021/11/08","107746580","7930000","136942030","36852220","289470830"
"2021/11/05","376456660","7960","471967740","57268400","905700760"
"2021/11/04","293898520","31890","125744190","20589760","440264360"
"2021/11/03","157909710","43529560","439541230","8644140","649624640"
"2021/11/02","403122230","74472000","421063230","35953390","934610850"
"2021/11/01","451248500","16030000","681362880","73071040","1221712420"
"2021/10/29","420042420","8835040","157926630","6152780","592956870"
"2021/10/28","229157620","14101970","112555650","50938560","406753800"
"2021/10/27","228746640","21101080","430628560","31790370","712266650"
"2021/10/26","133514080","0","203644290","171963870","509122240"
"2021/10/25","212418280","25474200","165441950","24208480","427542910"
"2021/10/22","113692870","80500","80522100","134363340","328658810"
"2021/10/21","220768520","8030000","49048600","3537490","281384610"
"2021/10/20","265518460","9077500","139917510","108088410","522601880"
"2021/10/19","249874690","0","392040370","155289760","797204820"
"2021/10/18","129087960","0","141476820","107942320","378507100"
"2021/10/15","209221450","138910730","368109560","70548440","786790180"
"2021/10/14","519742050","15990000","282766960","56868750","875367760"
"2021/10/13","535588410","0","98056590","33891420","667536420"
"2021/10/12","179534480","16000000","596130680","40012820","831677980"
"2021/10/08","194730120","8010000","191023930","69982140","463746190"
"2021/10/07","460342140",,"264435530","134838240","859615910"
"2021/10/06","541530480","79500","371027360","1795511980","2708149320"
"2021/10/05","478233430","15505070","333397350","83081420","910217270"
"2021/10/01","226262420","11792170","565959250","30200070","834213910"
"2021/09/30","154820870","25422900","186811930","94193980","461249680"
"2021/09/29","381912660","51847170","782571650","132930260","1349261740"
"2021/09/28","123088930","98292560","656443640","178206870","1056032000"
"2021/09/27","200923910","54795060","991829340","176018140","1423566450"
"2021/09/24","108993620","8200","655381100","20007560","784390480"
"2021/09/23","87045000","0","489390120","163112970","739548090"
"2021/09/17","193619520","1636000","332146140","3730840","531132500"
"2021/09/16","85659210","8190000","194563450","14037030","302449690"
"2021/09/15","55187230","0","194883540","17585840","267656610"
"2021/09/14","103889140","204630","293896780","26789080","424779630"
"2021/09/13","131908160","0","343090770","54787660","529786590"
"2021/09/10","39813180","0","106631520","21338240","167782940"
"2021/09/09","102873050","24570000","282415260","86848890","496707200"
"2021/09/08","95429100","5333250","270873150","122612590","494248090"
"2021/09/07","16876700","41110","417838640","116059650","550816100"
"2021/09/06","110295150","91888550","139180670","78820970","420185340"
"2021/09/03","146003290","24360000","769041530","245259520","1184664340"
"2021/09/02","164969550","24390000","220270530","85363190","494993270"
"2021/09/01","542848540","40590000","308368330","93634890","985441760"
"2021/08/31","491208800","19770050","315344730","183287340","1009610920"
"2021/08/30","150417640","811000","174475740","2086640","327791020"
"2021/08/27","117824010","16180","235530620","32423730","385794540"
"2021/08/26","258414330","0","154772810","4184180","417371320"
"2021/08/25","159776770","10551140","123681710","7723890","301733510"
"2021/08/24","165014760",,"153191400","20449670","338655830"
"2021/08/23","115514260","9089950","158295030","22478610","305377850"
"2021/08/20","306923390","4493610","543296220","53690150","908403370"
"2021/08/19","324670650","38195200","387932800","29624520","780423170"
"2021/08/18","483105000","25971270","411130280","112949400","1033155950"
"2021/08/17","444530720","114770140","256466470","10589830","826357160"
"2021/08/13","419845040","1003160","290927020","111090920","822866140"
"2021/08/12","228108210","7128200","253726240","196691530","685654180"
"2021/08/11","414079000","23965440","118544730","226080","556815250"
"2021/08/10","161311830","6089370","326845330","104610","494351140"
"2021/08/09","118055530","3929800","187238060","224460","309447850"
"2021/08/06","365907980","0","297002560","17273410","680183950"
"2021/08/05","46058740",,"196856000","34690220","277604960"
"2021/08/04","631520670","797000","306481910","119529630","1058329210"
"2021/08/03","111295510","1509900","230283520","136846080","479935010"
"2021/08/02","269693230","1595000","121219420","99119390","491627040"
"2021/07/30","260600410","795000","168427810","98235270","528058490"
"2021/07/29","407887850","13904500","345766470","26220550","793779370"
"2021/07/28","164049790","1573000","151919160","16577460","334119410"
"2021/07/27","158061890","19002050","376213760","8884780","562162480"
"2021/07/26","227532950","21912210","186331300","18751730","454528190"
"2021/07/23","205437330","15551080","301012350","27062340","549063100"
"2021/07/22","106938270","1583370","267474580","18326990","394323210"
"2021/07/21","91792600","2406850","186297150","1502145320","1782641920"
"2021/07/20","491177810","39382360","533984040","56237820","1120782030"
"2021/07/19","517466650","1587000","512095180","50534380","1081683210"
"2021/07/16","325556750","2586760","380750400","32544980","741438890"
"2021/07/15","967471950","800000","371221470","269340960","1608834380"
"2021/07/14","261091920","14919190","419114920","50607490","745733520"
"2021/07/13","261770250","176628790","412174150","109283190","959856380"
"2021/07/12","178025690","5517800","336727780","56325950","576597220"
"2021/07/09","510946730","1651840","444469270","137601050","1094668890"
"2021/07/08","607770030","9431000","514525720","43978280","1175705030"
"2021/07/07","361801300","24980960","587108680","1854920","975745860"
"2021/07/06","169169400","22942500","728049040","31438600","951599540"
"2021/07/05","261611700","19011580","853893700","85526980","1220043960"
"2021/07/02","277562430","8050000","333087790","32140210","650840430"
"2021/07/01","145413790","10720960","742237570","694120","899066440"
"2021/06/30","251977310","18511250","349928540","18122740","638539840"
"2021/06/29","281621750","1829250","199751590","18028480","501231070"
"2021/06/28","188200880","4050000","367766800","712410","560730090"
"2021/06/25","330370560","8125750","403096340","49177820","790770470"
"2021/06/24","229825240","5689000","356660420","37301230","629475890"
"2021/06/23","366571420","3688320","332789900","14485320","717534960"
"2021/06/22","133476010","0","180214720","36993150","350683880"
"2021/06/21","484389170","88588560","656541730","9913970","1239433430"
"2021/06/18","204346310",,"497988400","85657080","787991790"
"2021/06/17","240976030","12464000","386463460","1938410","641841900"
"2021/06/16","273512150","35028910","640269560","48184840","996995460"
"2021/06/15","618676210","7689920","635684790","160242800","1422293720"
"2021/06/14","453812230","85500500","1040785070","21662350","1601760150"
"2021/06/11","735055180","65599730","1123317260","2844890","1926817060"
"2021/06/10","220932370","27873300","361502150","25461740","635769560"
"2021/06/09","878814520","163516490","316325130","66181260","1424837400"
"2021/06/08","284356700","21280000","544958160","57401640","907996500"
"2021/06/07","538739250","42650000","504147010","37198650","1122734910"
"2021/06/04","636834730","86900","480827300","96231910","1213980840"
"2021/06/03","853352110","52130","328864630","54033410","1236302280"
"2021/06/02","1157125220","52159640","695088800","570639220","2475012880"
"2021/06/01","923816720","6698270","385250380","146052190","1461817560"
"2021/05/31","558149350","0","202769180","102600090","863518620"
"2021/05/28","539841850","39959090","264036210","110387090","954224240"
"2021/05/27","429376160","0","475612930","91191950","996181040"
"2021/05/26","136264340","10263060","267645560","37309100","451482060"
"2021/05/25","340919150","30121300","337311160","92105130","800456740"
"2021/05/24","192663060","8259200","227645740","42757660","471325660"
"2021/05/21","301465710","49210","329717540","112777180","744009640"
"2021/05/20","258675280","163700","138686920","81557560","479083460"
"2021/05/18","355553210","0","163951340","83980620","603485170"
"2021/05/17","274506420","8257330","366457150","61161040","710381940"
"2021/05/14","265934490","84128190","310547280","28802240","689412200"
"2021/05/13","623216470","1992600","281220160","215311310","1121740540"
"2021/05/12","552614130","0","472831070","62786560","1088231760"
"2021/05/11","559093670","9565700","289245950","392710260","1250615580"
"2021/05/10","524351910","16470000","611959500","396945540","1549726950"
"2021/05/07","332080970",,"302852420","92389110","727322500"
"2021/05/06","355447700",,"280590570","324501810","960540080"
"2021/05/04","843367970","107344560","1031936310","163362790","2146011630"
"2021/05/03","489955090","0","317102160","176001390","983058640"
"2021/04/30","556400420","29525640","415607460","239821570","1241355090"
"2021/04/29","562485170","0","464903030","294018040","1321406240"
"2021/04/28","761968140","3242120","529562990","61570410","1356343660"
"2021/04/27","502355390","40938220","751612020","507781870","1802687500"
"2021/04/26","622770420","51245000","538872850","179654110","1392542380"
"2021/04/23","698319460","0","582195170","323906340","1604420970"
"2021/04/22","794953290","7854950","636884900","349157830","1788850970"
"2021/04/21","305806480","8424100","375637310","123547460","813415350"
"2021/04/20","202180620","9191940","374944620","390803970","977121150"
"2021/04/19","250916970","7590","391675850","66937430","709537840"
"2021/04/16","201805310","0","167548880","107946890","477301080"
"2021/04/15","138043550",,"237257920","51070950","426372420"
"2021/04/14","241843250",,"212341510","67897100","522081860"
"2021/04/13","295263350","0","457402310","140615120","893280780"
"2021/04/12","106789370","9734000","289048790","114607760","520179920"
"2021/04/09","484426280","105316900","218452090","79213370","887408640"
"2021/04/08","338687150","747000","370512490","124900090","834846730"
"2021/04/07","236675560","74500","211600710","127543120","575893890"
"2021/04/06","500856790","75839570","468663690","34907610","1080267660"
"2021/04/05","286930880","53990150","439140730","8505710","788567470"
"2021/04/02","413140620","31053170","568649840","798220","1013641850"
"2021/04/01","394533290","38964070","276779080","93459730","803736170"
"2021/03/31","265364960","27100390","421028610","135859220","849353180"
"2021/03/30","488083580","4400640","845483630","128068850","1466036700"
"2021/03/29","1463144550","12209370","863911610","122214380","2461479910"
"2021/03/26","1751791750","15330","602106370","468593130","2822506580"
"2021/03/25","748853080","0","398982910","408118680","1555954670"
"2021/03/24","166179260","297170","527955310","95841110","790272850"
"2021/03/23","221785000","780130","374386670","103058870","700010670"
"2021/03/22","222799370","7348670","308065930","141104350","679318320"
"2021/03/19","202283020","114464750","517758220","53338400","887844390"
"2021/03/18","133910710","3717150","477454410","13631050","628713320"
"2021/03/17","270029260","3734500","247407910","55356400","576528070"
"2021/03/16","297911840","19625090","459989880","64440310","841967120"
"2021/03/15","95286260","7290","271856100","96425610","463575260"
"2021/03/12","211996300","14579060","159140130","3214200","388929690"
"2021/03/11","7572104330","36250","214395640","48058470","7834594690"
"2021/03/10","224004520","14550","115931330","23453580","363403980"
"2021/03/09","119764470","43410","249739400","31363440","400910720"
"2021/03/08","239805730","76289820","407398140","5016120","728509810"
"2021/03/05","392303250","12911860","283132220","5297950","693645280"
"2021/03/04","148952460","2547600","211328110","2343260","365171430"
"2021/03/03","117637510","15587700","142444690","4930260","280600160"
"2021/03/02","186964440","7230","335902390","59818180","582692240"
"2021/02/26","464470530","14340","153053710","48568230","666106810"
"2021/02/25","341573630","0","202950710","42941530","587465870"
"2021/02/24","526418220","0","179030070","57059030","762507320"
"2021/02/23","435530420","19039120","239504270","32784490","726858300"
"2021/02/22","182775990","0","201293590","53433830","437503410"
"2021/02/19","307579480","7040","274168910","51714790","633470220"
"2021/02/18","232180300","4977180","269847150","94613150","601617780"
"2021/02/17","373386500","95209220","361135080","100507660","930238460"
"2021/02/16","135420890","16144500","167016510","78807210","397389110"
"2021/02/15","406420490","8118500","747513850","110719530","1272772370"
"2021/02/10","74241930","159679120","298389230","8872210","541182490"
"2021/02/09","331203710","2127000","240459880","65038660","638829250"
"2021/02/08","141444070","1974000","376155310","86083340","605656720"
"2021/02/05","112891330","4939200","158852860","79897200","356580590"
"2021/02/04","111192480","28549130","142461300","45290190","327493100"
"2021/02/03","146979970","105994340","224569790","48137870","525681970"
"2021/02/02","124279570","215557220","156565370","201209050","697611210"
"2021/02/01","174391920","21420600","252618610","34464910","482896040"
"2021/01/29","311626540","14508420","445588440","33614810","805338210"
"2021/01/28","239662030","0","198152780","29188130","467002940"
"2021/01/27","399889430","11898000","153596140","29845990","595229560"
"2021/01/26","114460560","0","185768230","11481070","311709860"
"2021/01/25","334657400","21014000","404876310","169374580","929922290"
"2021/01/22","351082930","7080870","217611840","13264850","589040490"
"2021/01/21","195363510","14945000","201661070","34284910","446254490"
"2021/01/20","315026930","14372640","146952990","36083720","512436280"
"2021/01/19","170251690","3690900","525733110","49806490","749482190"
"2021/01/18","599822680","18844640","403752750","21096410","1043516480"
"2021/01/15","169260560","7683100","402112920","13568080","592624660"
"2021/01/14","175811620","1409030","390312690","30732780","598266120"
"2021/01/13","118737570","23284000","539102710","16003910","697128190"
"2021/01/12","170274100","0","436143250","91640060","698057410"
"2021/01/11","274524790","21030000","1184572320","53320620","1533447730"
"2021/01/08","145758370","24814000","412228100","7473410","590273880"
"2021/01/07","109870720","1426000","441836320","31281900","584414940"
"2021/01/06","444609520","0","369513980","73514520","887638020"
"2021/01/05","503099190","0","464662000","24462450","992223640"
"2021/01/04","296432120","0","522188960","26970900","845591980"
"2020/12/30","336640330","711000","154750800","27449240","519551370"
"2020/12/29","151486030","75984000","401351150","49323820","678145000"
"2020/12/28","233706060","0","308741420","53071590","595519070"
"2020/12/24","319369140","0","246046470","45875430","611291040"
"2020/12/23","190024040","10585000","221200490","14784900","436594430"
"2020/12/22","74668100","0","151505080","6310930","232484110"
"2020/12/21","244512060","0","232364190","15283880","492160130"
"2020/12/18","181155160","712000","150485850","46200150","378553160"
"2020/12/17","400818330","0","369495550","114504000","884817880"
"2020/12/16","110561140","0","155651070","50369250","316581460"
"2020/12/15","380184730","35000000","589619190","39648170","1044452090"
"2020/12/14","385153330","74946000","452218970","51152720","963471020"
"2020/12/11","660865280","0","570502090","69296220","1300663590"
"2020/12/10","405946180","0","256791830","39251310","701989320"
"2020/12/09","381961940","0","329809420","0","711771360"
"2020/12/08","182542470",,"198407820","30722950","411673240"
"2020/12/07","499103250","0","475830010","32878270","1007811530"
"2020/12/04","85863090","0","303126110","21827440","410816640"
"2020/12/03","86323050","0","346947820","2057100","435327970"
"2020/12/02","5312850","8882780","295280270","5210150","314686050"
"2020/12/01","113038700","29829410","262204170","6497360","411569640"
"2020/11/30","399511280","997650","320191170","52203900","772904000"
"2020/11/27","103022520","29350960","277390870","14740","409779090"
"2020/11/26","142370130",,"187679940","4249080","334299150"
"2020/11/25","102952200",,"177705690","11432190","292090080"
"2020/11/24","268188650","1096500","381172160","98742880","749200190"
"2020/11/23","153845940","2193000","278266840","68040290","502346070"
"2020/11/20","90593240",,"673200510","94019600","857813350"
"2020/11/19","270480460","2142000","249065350","0","521687810"
"2020/11/18","143282000",,"251718780","46830560","441831340"
"2020/11/17","183402780","1436000","133467680","71900","318378360"
"2020/11/16","160935700",,"241360830","31929200","434225730"
"2020/11/13","192379240","2852000","163275180","5847040","364353460"
"2020/11/12","70178580","0","85703470","12084110","167966160"
"2020/11/11","231872440","1385740","242365600","6848930","482472710"
"2020/11/10","260467900","2874000","197017200","109089470","569448570"
"2020/11/09","203178570",,"245483710","35850","448698130"
"2020/11/06","88564830","2952000","128786420","102163200","322466450"
"2020/11/05","299580880",,"287019960","7211120","593811960"
"2020/11/04","199280290",,"154284770","20492720","374057780"
"2020/11/03","233866270","71500000","124663260","24932330","454961860"
"2020/11/02","552474100",,"178452260","19562610","750488970"
"2020/10/30","756069420","0","236629000","94487500","1087185920"
"2020/10/29","66458820","14235650","487164790","16264910","584124170"
"2020/10/28","91078610","57851510","215733620","45739000","410402740"
"2020/10/27","390082660",,"455209080","91570430","936862170"
"2020/10/26","309087840","56319010","403452930","574080","769433860"
"2020/10/23","316988820","62335000","734268180","1547820","1115139820"
"2020/10/22","402773190","60501320","441006110","70322720","974603340"
"2020/10/21","188251600","15518130","544866600","41418650","790054980"
"2020/10/20","153670550","167739030","299978020","89646310","711033910"
"2020/10/19","420772160","3987500","233928860","90355600","749044120"
"2020/10/16","521834520","22071570","164029100","28593420","736528610"
"2020/10/15","509928780","0","173899100","48198630","732026510"
"2020/10/14","186415060","1356000","326854950","17533250","532159260"
"2020/10/13","198555930","2004750","316450080","45748230","562758990"
"2020/10/12","159749620","995190","131765110","12244690","304754610"
"2020/10/08","227254030","0","313274010","21096490","561624530"
"2020/10/07","228235600","3016520","487683940","50115240","769051300"
"2020/10/06","133723850","4379600","193976200","7540310","339619960"
"2020/10/05","338769430","1004920","164304320","47680860","551759530"
"2020/09/29","541373140","3059840","121737600","61210850","727381430"
"2020/09/28","307353030","2047440","436211840","119350660","864962970"
"2020/09/25","81063980",,"817873410","131801810","1030739200"
"2020/09/24","154273380","6832700","397691980","211251000","770049060"
"2020/09/23","191980320","6780000","196230390","175220490","570211200"
"2020/09/22","149950530","3385000","229825290","65944330","449105150"
"2020/09/21","87456240","1364000","336113890","36518110","461452240"
"2020/09/18","94821640","13640000","297915720","76380040","482757400"
"2020/09/17","122323130","682000","162911240","2520270","288436640"
"2020/09/16","114164840","2871380","331682190","26496510","475214920"
"2020/09/15","110077560","23863650","496299970","65270820","695512000"
"2020/09/14","79377630","14724500","604085160","38224940","736412230"
"2020/09/11","128278690","13500000","330492220","8099590","480370500"
"2020/09/10","70314670","5047190","509114560","16554870","601031290"
"2020/09/09","150668240","2546000","528361150","34406790","715982180"
"2020/09/08","77011630","81080000","877776020","88289240","1124156890"
"2020/09/07","84635460","0","419067910","19198080","522901450"
"2020/09/04","171843260","997500","408986420","40065380","621892560"
"2020/09/03","261169090","2492880","124219710","36645000","424526680"
"2020/09/02","45795320","2648000","195195770","40179520","283818610"
"2020/09/01","99783050","9951000","251645310","20459180","381838540"
"2020/08/31","177393670","72116140","364700100","50840960","665050870"
"2020/08/28","131340550","13957000","162656270","53274350","361228170"
"2020/08/27","102819510","1288160","300150760","63726680","467985110"
"2020/08/26","82923450","0","195469550","61874230","340267230"
"2020/08/25","160818870","15511640","356416490","151353990","684100990"
"2020/08/24","75475370","3921000","292243680","102987160","474627210"
"2020/08/21","144838090","15543000","287409550","72156910","519947550"
"2020/08/20","142202870","15458800","476782330","9846260","644290260"
"2020/08/19","238268720","0","308206020","61911760","608386500"
"2020/08/18","482891380","6530000","814746380","16121190","1320288950"
"2020/08/14","228807540","0","370200220","23121030","622128790"
"2020/08/13","284878350","21847710","482121430","12143310","800990800"
"2020/08/12","146150640","33231480","692391370","384861370","1256634860"
"2020/08/11","138125510","33140390","721636980","161338440","1054241320"
"2020/08/10","79433070","14587710","535976240","74762890","704759910"
"2020/08/07","205972890","649000","607761950","143596780","957980620"
"2020/08/06","85978140","8461000","305601570","60302260","460342970"
"2020/08/05","255239900","19530000","511358530","23661620","809790050"
"2020/08/04","78249250","655000","561552850","90098490","730555590"
"2020/08/03","116728020","2395680","391652860","35204870","545981430"
"2020/07/31","158748310","653000","292518030","3381200","455300540"
"2020/07/30","100207080","0","292918280","339040","393464400"
"2020/07/29","78604080","1947000","356109350","44719960","481380390"
"2020/07/28","236435500","27162440","268411000","9650620","541659560"
"2020/07/27","239564820","101305930","685947390","58675050","1085493190"
"2020/07/24","230477430","7108000","449115680","13053550","699754660"
"2020/07/23","169777730","22877800","310673770","1313520","504642820"
"2020/07/22","161430730","21584000","319421810","11074080","513510620"
"2020/07/21","170302200",,"514688120","21216950","706207270"
"2020/07/20","123243090","657000","733469780","237337610","1094707480"
"2020/07/17","46531240","44511000","412549670","42036000","545627910"
"2020/07/16","131891330","1935000","383339220","55865340","573030890"
"2020/07/15","79709450","20942910","348227760","24364750","473244870"
"2020/07/14","72466240","16220000","190084070","6512470","285282780"
"2020/07/13","453160090","393450","387009620","64900","840628060"
"2020/07/10","215975690","651130","310178080","508760","527313660"
"2020/07/09","292897490","0","205776280","40378820","539052590"
"2020/07/08","481226480","5132130","765499490","7142280","1259000380"
"2020/07/07","212945020","6530000","397564370","55165030","672204420"
"2020/07/06","299048450","5651650","660260190","21997340","986957630"
"2020/07/03","210095580","66100","346036090","33295700","589493470"
"2020/07/02","102300390","19960","281405750","67934460","451660560"
"2020/07/01","153946050","6723230","219544850","44340470","424554600"
"2020/06/30","493394090","6670","186500310","55827400","735728470"
"2020/06/29","271819760","145950","386697620","10216630","668879960"
"2020/06/26","270887600","0","237311970","67735680","575935250"
"2020/06/25","192891750","7264880","470870470","13236920","684264020"
"2020/06/24","112537540","5317550","268755600","38528140","425138830"
"2020/06/23","189335310","28689770","384862770","11893530","614781380"
"2020/06/22","235974630","13352210","303328080","5458030","558112950"
"2020/06/19","121213900","13426730","370601390","18664570","523906590"
"2020/06/18","156891130","20110","309015980","106685620","572612840"
"2020/06/17","231892960","1348000","211605190","229059820","673905970"
"2020/06/16","154302820","4096910","449771880","46313450","654485060"
"2020/06/15","295458850","46109840","708264470","63745980","1113579140"
"2020/06/12","405070960","10913520","696844800","149128830","1261958110"
"2020/06/11","368861640","51343150","797045610","120091510","1337341910"
"2020/06/10","210903390","36592210","631777770","342930210","1222203580"
"2020/06/09","177824700","73102940","921833900","363477230","1536238770"
"2020/06/08","124836050","60568380","730403360","204409330","1120217120"
"2020/06/05","171039340","20542970","1966717910","336334680","2494634900"
"2020/06/04","227849190","45681630","972500960","101468880","1347500660"
"2020/06/03","364700280","33213490","790896950","156231700","1345042420"
"2020/06/02","212926920","7016970","443414020","269780450","933138360"
"2020/06/01","180467710","7181900","427206830","108681730","723538170"
"2020/05/29","111583980","1400000","198604540","240815530","552404050"
"2020/05/28","170671610","83990","809252430","305309170","1285317200"
"2020/05/27","490130810","12060820","486130010","70217310","1058538950"
"2020/05/26","321311060","9087000","1039506660","332089200","1701993920"
"2020/05/25","274678730","10530710","542530300","219918910","1047658650"
"2020/05/22","809846750","7578500","1074312090","393459590","2285196930"
"2020/05/21","345470150","29572880","1814563080","573701220","2763307330"
"2020/05/20","99551310","7304250","797065530","228634570","1132555660"
"2020/05/19","206580880","12984810","899640120","591932850","1711138660"
"2020/05/18","92660100","23064710","568038010","203397350","887160170"
"2020/05/15","188562350","0","287463240","159825950","635851540"
"2020/05/14","362183900","12677690","1100782740","108361290","1584005620"
"2020/05/13","203131540","1875230","646515180","68794160","920316110"
"2020/05/12","142354060","2533150","622320390","108449780","875657380"
"2020/05/11","76522950","1905000","394355190","225925600","698708740"
"2020/05/08","593672750","2421220","681975660","156182970","1434252600"
"2020/05/07","542912600","26098150","514657100","100104270","1183772120"
"2020/05/06","193442280","26270000","261197600","38519200","519429080"
"2020/05/04","73721300","28133750","393441740","46465400","541762190"
"2020/04/29","213971040","19330000","207498940","225509880","666309860"
"2020/04/28","141432730","85281700","193301920","134387920","554404270"
"2020/04/27","73063270","31107600","214919620","118064630","437155120"
"2020/04/24","59033220","29145320","326723820","4454860","419357220"
"2020/04/23","242216320","26166950","374298560","84851730","727533560"
"2020/04/22","303468130","29321190","798084410","133841880","1264715610"
"2020/04/21","147662770","34575670","515205690","99385060","796829190"
"2020/04/20","161862540","6184390","335128100","57825260","561000290"
"2020/04/17","541199130","3993650","203006600","115226890","863426270"
"2020/04/16","23134800","15534740","176093960","63687040","278450540"
"2020/04/14","107644530","8732260","470792030","30440160","617608980"
"2020/04/13","345126180","1999270","196790230","83888850","627804530"
"2020/04/10","196545840","2655610","233068790","193490500","625760740"
"2020/04/09","194127320","13781590","133639100","99676630","441224640"
"2020/04/08","294507650","70818860","462234960","266227060","1093788530"
"2020/04/07","134933800","0","546244650","51795980","732974430"
"2020/04/06","280159460","21924320","280705240","96312080","679101100"
"2020/04/03","392833340","701570","128246700","92355870","614137480"
"2020/04/02","169584870","41763900","154941360","42225950","408516080"
"2020/04/01","726020240","57857370","418925900","205607990","1408411500"
"2020/03/31","388578730","696550","290612610","80287650","760175540"
"2020/03/30","727934980","688650","356334370","95952470","1180910470"
"2020/03/27","1594900910","681000","747961140","215356590","2558899640"
"2020/03/26","842123690","2931280","578038820","292637460","1715731250"
"2020/03/25","813647490","7025890","931650360","135141290","1887465030"
"2020/03/24","455722950","625550","718943060","75969090","1251260650"
"2020/03/23","404285580","31938080","756507350","30352130","1223083140"
"2020/03/20","721370010","1876050","1097299190","85745640","1906290890"
"2020/03/19","939275330","61025960","1092863570","229169050","2322333910"
"2020/03/18","786585080","678000","515023510","52556100","1354842690"
"2020/03/17","672586210","32206440","576833050","174360720","1455986420"
"2020/03/16","408435480","4993260","945528990","120801790","1479759520"
"2020/03/13","1337811230","834900","1538123480","501711720","3378481330"
"2020/03/12","1124160480","3146160","533720580","48699150","1709726370"
"2020/03/11","533663900","22791370","468290080","123064710","1147810060"
"2020/03/10","402573600","2936480","223586440","200192010","829288530"
"2020/03/09","897258440","1487030","358457430","95290640","1352493540"
"2020/03/06","542047340","2258640","234822030","53538440","832666450"
"2020/03/05","939811370","0","761236780","571311090","2272359240"
"2020/03/04","940186250","1440000","1001890160","367678290","2311194700"
"2020/03/03","114097790","1409100","263214330","49050580","427771800"
"2020/03/02","673789190","2938700","397063500","112606530","1186397920"
"2020/02/28","755430960","10294630","840339310","18620330","1624685230"
"2020/02/27","123651540","35250","161440720","5183220","290310730"
"2020/02/26","378291950","14050","348311150","21181070","747798220"
"2020/02/25","268594350","0","309324660","250488500","828407510"
"2020/02/24","362573900","5743250","555872090","139253990","1063443230"
"2020/02/21","139706670","1545150","207404800","84893210","433549830"
"2020/02/20","139260480","10321330","233277280","124108760","506967850"
"2020/02/19","422308590","6855820","345331070","255085790","1029581270"
"2020/02/18","256233090","43574900","300032960","38073930","637914880"
"2020/02/17","385942380","15603000","481356590","38554560","921456530"
"2020/02/14","400893000","4888740","827048860","3358880","1236189480"
"2020/02/13","401513330","1351220","176642150","11412090","590918790"
"2020/02/12","428867930","6679790","485797690","13171710","934517120"
"2020/02/11","569094930","760000","243695160","134560140","948110230"
"2020/02/10","188828260","778530","121528980","27210490","338346260"
"2020/02/07","73229970","1677100","85056210","10726830","170690110"
"2020/02/06","115897560","763530","214380520","53804340","384845950"
"2020/02/05","532829530","2274050","324040680","43838780","902983040"
"2020/02/04","198434280","22890","267003240","48419590","513880000"
"2020/02/03","592355970","100244240","260685750","200868080","1154154040"
"2020/01/31","533592000","753000","112529090","36192480","683066570"
"2020/01/30","349196830","0","89158780","103409490","541765100"
"2020/01/29","260014200","775560","243616310","14186800","518592870"
"2020/01/28","243184150","7411840","425894410","76269970","752760370"
"2020/01/23","223389680","17302440","231939470","10066770","482698360"
"2020/01/22","212720010","14980","153415260","8737500","374887750"
"2020/01/21","896972430","12610000","245327170","65636840","1220546440"
"2020/01/20","326010680","22310","149595030","14136650","489764670"
"2020/01/17","341800400","759450","114766970","14922590","472249410"
"2020/01/16","301204620","7520000","544630370","188593000","1041947990"
"2020/01/15","420293390","101011840","120647710","154207630","796160570"
"2020/01/14","493523160","118002850","689105380","291497990","1592129380"
"2020/01/13","446455970","13618610","940414650","38455580","1438944810"
"2020/01/10","155582040","16047610","233759230","33336900","438725780"
"2020/01/09","248989720","17733430","206416800","62085060","535225010"
"2020/01/08","443498730","21210200","183866910","6616910","655192750"
"2020/01/07","342699220","16913500","206233930","12851060","578697710"
"2020/01/06","323428460","16355230","323240650","3187830","666212170"
"2020/01/03","904062000","95745420","484270660","16172580","1500250660"
"2020/01/02","505791910","94251640","655922730","232233230","1488199510"
"2019/12/30","506730450",,"240108910","4136750","750976110"
"2019/12/27","533840600","91685360","374601350","2499350","1002626660"
"2019/12/26","476646130","79943030","338952020","162032570","1057573750"
"2019/12/24","158699720","79695070","380548520","11229590","630172900"
"2019/12/23","144979760","1883880","429661810","8052790","584578240"
"2019/12/20","257876980","3024000","376105770","204438180","841444930"
"2019/12/19","306827570","233187440","539954610","79911950","1159881570"
"2019/12/18","343697210","1556370","340343980","105091150","790688710"
"2019/12/17","603110200","218590480","360387940","109551320","1291639940"
"2019/12/16","1539014120","427561690","846416650","389338570","3202331030"
"2019/12/13","1631545890","607490920","601983440","507392150","3348412400"
"2019/12/12","1250984480","59656000","820997170","734501970","2866139620"
"2019/12/11","637025380","7039560","1409975490","858324670","2912365100"
"2019/12/10","854162040","1533610","821995700","891801130","2569492480"
"2019/12/09","382816630","31441450","990260460","752400610","2156919150"
"2019/12/06","249489920","85327260","427050950","154728890","916597020"
"2019/12/05","124866560","121596400","351155360","324990390","922608710"
"2019/12/04","86695770","42223000","542841580","351178990","1022939340"
"2019/12/03","749621930","36720800","1130680600","118072400","2035095730"
"2019/12/02","172608440","245711530","189206180","61816250","669342400"
"2019/11/29","567596950","42051900","329179660","73021610","1011850120"
"2019/11/28","147374580","164425000","385769530","17415410","714984520"
"2019/11/27","199628950","1384130","335816700","17585040","554414820"
"2019/11/26","528841170","4181850","414132490","167632800","1114788310"
"2019/11/25","421645720","5768160","449144320","32324550","908882750"
"2019/11/22","308905750","864960","236648150","257395910","803814770"
"2019/11/21","625395690","2521490","396997730","512054870","1536969780"
"2019/11/20","489098380","5914070","520923470","522832820","1538768740"
"2019/11/19","822511070","869230","1011502190","430384620","2265267110"
"2019/11/18","1463240090","3259160","3227998970","1370919270","6065417490"
"2019/11/15","781369150","892160","1518610340","401614600","2702486250"
"2019/11/14","1907838920","9403780","1348291440","993614630","4259148770"
"2019/11/13","1050875330","2633730","1132249500","381766440","2567525000"
"2019/11/12","176358690","42067720","645829240","69136170","933391820"
"2019/11/11","619861750","1782840","1297482800","567125200","2486252590"
"2019/11/08","774148360","2205300","3111242500","835120190","4722716350"
"2019/11/07","753875240","10866860","1207822620","770378990","2742943710"
"2019/11/06","1109453690","1856700","1044367980","819512890","2975191260"
"2019/11/05","1152097110","14534010","1094396060","273655830","2534683010"
"2019/11/04","609486120","15362080","933107710","325467380","1883423290"
"2019/11/01","4446313990","12085610","361752060","221021640","5041173300"
"2019/10/31","654689500","2999500","624911100","338795750","1621395850"
"2019/10/30","711197630","54673680","792210280","804466660","2362548250"
"2019/10/29","432639430","14385070","577577630","218629880","1243232010"
"2019/10/28","249086890","1673600","465844090","698890470","1415495050"
"2019/10/25","601456670","46294090","369600410","142558870","1159910040"
"2019/10/24","396548290","1670000","473850970","79562850","951632110"
"2019/10/23","342145900","3681980","562659930","320587920","1229075730"
"2019/10/22","371048220","569690","1027696390","100417650","1499731950"
"2019/10/21","619045940","6190730","1194919670","324446130","2144602470"
"2019/10/18","585462280","503400","982749990","378517960","1947233630"
"2019/10/17","192367810","81500","739117070","715183410","1646749790"
"2019/10/16","170817700","5528110","957072050","267838480","1401256340"
"2019/10/15","635584030","5493070","466084240","682779760","1789941100"
"2019/10/14","198111520","910820","357811730","107612240","664446310"
"2019/10/11","185526000","15804210","261106170","214855530","677291910"
"2019/10/10","402610600","0","153820800","112027050","668458450"
"2019/10/08","247318860","6392870","372197300","116739300","742648330"
"2019/10/07","148466370","15501320","595892360","126103290","885963340"
"2019/10/04","189544700","23940000","471200200","231505500","916190400"
"2019/10/02","452111930","0","315655920","117765330","885533180"
"2019/10/01","385433930","26862380","157252650","27256510","596805470"
"2019/09/30","454140120","0","300872780","178874330","933887230"
"2019/09/27","373218110","1590000","491763250","18040680","884612040"
"2019/09/26","285457350","999750","449620210","49537720","785615030"
"2019/09/25","95373140","807930","823972090","55437880","975591040"
"2019/09/24","190769570","798000","409979070","233497130","835043770"
"2019/09/23","156589300","154348160","416462700","95516150","822916310"
"2019/09/20","180548740","0","734508070","225284820","1140341630"
"2019/09/19","418060130","120550","457241560","152224950","1027647190"
"2019/09/18","20909200","2429430","457118500","17999460","498456590"
"2019/09/17","51770240","795000","560782580","72405450","685753270"
"2019/09/16","17642930","0","948794690","654360","967091980"
"2019/09/11","200630720","139745930","593230920","268886810","1202494380"
"2019/09/10","218199260","189325760","869544680","394136260","1671205960"
"2019/09/09","322175420","6387620","886984330","102564560","1318111930"
"2019/09/06","123835830","8808990","390488350","57384310","580517480"
"2019/09/05","481291290","170209050","1230784640","43224070","1925509050"
"2019/09/04","129191080","173527680","1200231930","283930400","1786881090"
"2019/09/03","126062530","407416730","1095117650","156777290","1785374200"
"2019/09/02","37818990","329669890","1094372720","243017090","1704878690"
"2019/08/30","205380770","94363320","482888160","69685100","852317350"
"2019/08/29","37035370","10245800","116500780","25136870","188918820"
"2019/08/28","6768460","351090","604304370","79683640","691107560"
"2019/08/27","127315780","10332500","253921510","45324410","436894200"
"2019/08/26","198123190","11487000","345177680","19077160","573865030"
"2019/08/23","73386750","46496070","296000880","83534210","499417910"
"2019/08/22","483558200","2814300","371514580","147321650","1005208730"
"2019/08/21","41509610","4068890","416757390","42094760","504430650"
"2019/08/20","84956840","7275000","262719750","84559540","439511130"
"2019/08/19","91577710","43430050","363183470","56369160","554560390"
"2019/08/16","291331580","13537160","116018580","42337980","463225300"
"2019/08/14","340853680","22780140","105592920","20620400","489847140"
"2019/08/13","163594200","1750590","163499130","61592310","390436230"
"2019/08/12","111396780","7781600","230995140","24855070","375028590"
"2019/08/09","233240190","710000","197722800","83763210","515436200"
"2019/08/08","167362750","1688780","222384420","90538410","481974360"
"2019/08/07","671071080","2154000","385380530","95813970","1154419580"
"2019/08/06","401764380","13944260","715608820","479001600","1610319060"
"2019/08/05","420386460","1465530","334962070","115369250","872183310"
"2019/08/02","124599510","7110","278532890","73081390","476220900"
"2019/08/01","254355030","67152610","381592370","19293420","722393430"
"2019/07/31","580341960","21565120","221763740","65461610","889132430"
"2019/07/30","197299080","11415230","279012690","64506730","552233730"
"2019/07/29","477041300","13132290","214194600","24355110","728723300"
"2019/07/26","232653750","10071200","190256310","13568790","446550050"
"2019/07/25","345901800","10132230","262028250","4822960","622885240"
"2019/07/24","373263860","14656570","171315960","8827340","568063730"
"2019/07/23","163063160","7179820","230990890","10411070","411644940"
"2019/07/22","281941020","103851610","261118950","59212170","706123750"
"2019/07/19","99916740","7399040","425158110","186050730","718524620"
"2019/07/18","104444270","7314070","283467870","144213490","539439700"
"2019/07/17","296216390","7880040","314861720","115014400","733972550"
"2019/07/16","448472470","1597070","312853730","115318040","878241310"
"2019/07/15","430085210","131941300","709100320","268042660","1539169490"
"2019/07/12","198727860","3157590","459764980","70300","661720730"
"2019/07/11","215386490","1082370","438411600","12886540","667767000"
"2019/07/10","371861820","7885700","585709630","99467510","1064924660"
"2019/07/09","75367860","27328130","662092470","108601550","873390010"
"2019/07/08","42864920","68416080","534749020","41359400","687389420"
"2019/07/05","7154140","10453800","304141380","9154220","330903540"
"2019/07/04","6363100","11468480","541478720","42974890","602285190"
"2019/07/03","73747780","28480000","941565340","239539960","1283333080"
"2019/07/02","235446110","21973080","1124538670","212563590","1594521450"
"2019/07/01","11377390","4925190","517972210","41944090","576218880"
"2019/06/28","138038940","8811530","244096480","45200740","436147690"
"2019/06/27","134788110","0","167729000","5998570","308515680"
"2019/06/26","154911490","14182180","488960580","41016180","699070430"
"2019/06/25","38767370","5432000","574781930","58012610","676993910"
"2019/06/24","92240970","3548760","376703710","37667190","510160630"
"2019/06/21","120480270","18548640","384464110","6327180","529820200"
"2019/06/20","157646090","8143000","669788700","42896920","878474710"
"2019/06/19","113736310","0","272281460","8712950","394730720"
"2019/06/18","155830130","69611710","600258530","98558700","924259070"
"2019/06/17","81403280","9783970","184495030","122906980","398589260"
"2019/06/14","9970100","8042400","292149090","27252350","337413940"
"2019/06/13","46262250","1254680","250836610","42556150","340909690"
"2019/06/12","71513860","9961740","260971510","46856740","389303850"
"2019/06/11","134601090","13019620","452732490","121451260","721804460"
"2019/06/10","155577880","2550500","176900350","37716350","372745080"
"2019/06/07","8151290","4060350","216578210","11963570","240753420"
"2019/06/05","134596750","5232330","272737310","14832580","427398970"
"2019/06/04","22558330","44546920","220867940","43426310","331399500"
"2019/06/03","725565120","10577300","216037940","20670010","972850370"
"2019/05/31","229638060","10437000","435745680","72448960","748269700"
"2019/05/30","84974610","16015020","365705510","32354710","499049850"
"2019/05/29","133072910","10738460","239446290","56964070","440221730"
"2019/05/28","224020470","37191280","795946740","35938240","1093096730"
"2019/05/27","227071760","51821130","328096520","78014010","685003420"
"2019/05/24","112154090","24953150","572338700","156892900","866338840"
"2019/05/23","53360410","129502050","313221370","59019790","555103620"
"2019/05/22","105377550","54409620","316933550","41171280","517892000"
"2019/05/21","177862990","47803460","497871650","78551300","802089400"
"2019/05/20","24615950","37287430","658065880","74386950","794356210"
"2019/05/17","132177660","8296160","506150510","128147220","774771550"
"2019/05/16","41173570","0","300796640","21719970","363690180"
"2019/05/15","80235090","2976870","179259340","7001940","269473240"
"2019/05/14","53333230","613540","387179750","2173100","443299620"
"2019/05/13","34796980","300480","290988450","836360","326922270"
"2019/05/10","29632100","51815560","299824880","2406600","383679140"
"2019/05/09","36933920","636300","1019057970","53680110","1110308300"
"2019/05/08","604130270","22035700","377157610","115394000","1118717580"
"2019/05/07","158254730","6180","220349210","22976780","401586900"
"2019/05/03","123338140","5416250","145588990","1873570","276216950"
"2019/05/02","79917750","12878000","365776110","13422030","471993890"
"2019/04/30","101904450","4205160","161352030","2780100","270241740"
"2019/04/29","152600060","0","482638530","509430","635748020"
"2019/04/26","66912030","0","218535380","1091310","286538720"
"2019/04/25","176108330","22394940","675195260","7171810","880870340"
"2019/04/24","68151830","10023580","710372090","29401530","817949030"
"2019/04/23","70248340","0","420111390","3557200","493916930"
"2019/04/22","74754800","185923240","425366380","20447340","706491760"
"2019/04/19","79773470","3658000","179420070","0","262851540"
"2019/04/18","259975790","976000","193767380","48375310","503094480"
"2019/04/17","232510050","7037000","161521610","23258830","424327490"
"2019/04/16","136233820","9551010","513776000","247398500","906959330"
"2019/04/15","210880080","68448220","424165120","37385970","740879390"
"2019/04/12","200723990","21385250","749737050","140284150","1112130440"
"2019/04/11","1188151200","161984830","672971240","477319350","2500426620"
"2019/04/10","328373090","58625480","304688990","287661130","979348690"
"2019/04/09","78712390","199411170","72768160","22559000","373450720"
"2019/04/08","22338590","62188550","352353030","52069680","488949850"
"2019/04/05","47635770","4078000","99186450","14269350","165169570"
"2019/04/04","143799980","23904060","674235590","13636890","855576520"
"2019/04/03","104363340","25382240","101948970","54061850","285756400"
"2019/04/02","229801590","14649840","113381830","11411510","369244770"
"2019/04/01","304826960","618380","546764730","175802440","1028012510"
"2019/03/29","173256220","24072620","279162530","80678990","557170360"
"2019/03/28","152829030","591000","240006140","99627500","493053670"
"2019/03/27","232408380","4179520","549084880","49730040","835402820"
"2019/03/26","197260610","593720","423145740","238752930","859753000"
"2019/03/25","87618290","60530190","615989850","101482260","865620590"
"2019/03/22","157342600","589850","631335580","132627630","921895660"
"2019/03/21","152166190","585000","488856490","66598520","708206200"
"2019/03/20","81283680","588000","815741070","82054350","979667100"
"2019/03/19","171363990","12201370","290834420","17545350","491945130"
"2019/03/18","63963960","579000","399834550","89722600","554100110"
"2019/03/15","56737840","1147000","150334930","87054650","295274420"
"2019/03/14","57062770","1142000","124113200","87676270","269994240"
"2019/03/13","93007350","7428080","295952230","40778160","437165820"
"2019/03/12","73040340","59100500","440822410","33034430","605997680"
"2019/03/11","82797190","17824680","516683510","87787510","705092890"
"2019/03/08","108362460","14603750","195008540","20680770","338655520"
"2019/03/07","32075690","1132000","168510300","16959410","218677400"
"2019/03/06","68729090","570640","279467120","30919660","379686510"
"2019/03/05","55394780","570650","224038560","7161650","287165640"
"2019/03/04","58442380","565000","435372700","11795680","506175760"
"2019/02/28","9135960","3344900","112866200","8409630","133756690"
"2019/02/27","76124430","112563000","116223790","64785170","369696390"
"2019/02/26","57535970","561500","169195090","46504870","273797430"
"2019/02/25","62522920","0","299279210","8075200","369877330"
"2019/02/22","95828420","560000","296295570","3412980","396096970"
"2019/02/21","75453320","10546260","174008240","755760","260763580"
"2019/02/20","136789430","591150","186624300","16618770","340623650"
"2019/02/19","85583020","1700000","340064110","162912230","590259360"
"2019/02/18","70191380","0","118930150","68971120","258092650"
"2019/02/15","100627410","0","242923420","92411040","435961870"
"2019/02/14","95220130","5640","71935920","0","167161690"
"2019/02/13","82457960","28360","176599330","42578380","301664030"
"2019/02/12","31577610","5640","195452960","144518510","371554720"
"2019/02/11","30544540","0","180329700","88482580","299356820"
"2019/02/08","49483250","0","68959530","11343000","129785780"
"2019/02/07","59626540","5570","105283490","111820","165027420"
"2019/02/01","76075990","11220","134014610","1908960","212010780"
"2019/01/31","457583510","17275680","51433620","125780750","652073560"
"2019/01/30","175537530","11050","180493800","4648750","360691130"
"2019/01/29","120563340","1948851970","129677300","125025970","2324118580"
"2019/01/28","159345450","16491970","240689500","28051080","444578000"
"2019/01/25","64284480",,"239691820","7771180","311747480"
"2019/01/24","43994150",,"118522660","28954000","191470810"
"2019/01/23","124259930","16310","333980080","20136300","478392620"
"2019/01/22","79464140",,"269889340","0","349353480"
"2019/01/21","28471580",,"243983480","21640","272476700"
"2019/01/18","68092330",,"102424040","1617000","172133370"
"2019/01/17","73090250","0","174203700","3459500","250753450"
"2019/01/16","82291300","24090000","377176170","40163610","523721080"
"2019/01/15","121736960","13445000","401993390","30680700","567856050"
"2019/01/14","139093880","5400","149450380","0","288549660"
"2019/01/11","81072360","27077020","404822830","5826240","518798450"
"2019/01/10","59788620","10760","379638590","0","439437970"
"2019/01/09","78034770","33609050","221809190","3155200","336608210"
"2019/01/08","60708690","92381160","501368880","10739360","665198090"
"2019/01/07","188368790","38219620","452293330","31744120","710625860"
"2019/01/04","112192460","72417800","135708430","1224340","321543030"
"2019/01/03","58584240","123859900","119325290","12131140","313900570"
"2019/01/02","47825530","28002440","73436730","0","149264700"