일자,기관 합계,기타법인,개인,외국인 합계,전체
"2023/05/04","72757760","2086510","54280335","418655","129543260"
"2023/05/03","8234150","537350","56844790","2999335","68615625"
"2023/05/02","5143085","800515","25685900","4570025","36199525"
"2023/04/28","43108040","804370","55463150","344895","99720455"
"2023/04/27","25108165","799845","34833495","0","60741505"
"2023/04/26","81712860","2031720","20086685","6064105","109895370"
"2023/04/25","4670040","804960","26707310","0","32182310"
"2023/04/24","128210585","797460","107078690","19765640","255852375"
"2023/04/21","62357665","2232790","22758615","17760520","105109590"
"2023/04/20","82550175","805235","14477285","38600045","136432740"
"2023/04/19","59588850","5692750","52596570","3866950","121745120"
"2023/04/18","68149150","2248825","218151125","33455630","322004730"
"2023/04/17","50826305","2423075","23454530","32990630","109694540"
"2023/04/14","57066000","802680","59646750","38388725","155904155"
"2023/04/13","26566010","807025","19474100","0","46847135"
"2023/04/12","75410305","800545","47731445","230250","124172545"
"2023/04/11","48394235","4069395","39899285","18383195","110746110"
"2023/04/10","10430430","4035190","122004980","0","136470600"
"2023/04/07","50073265","2019385","22301865","17623660","92018175"
"2023/04/06","65249630","1824845","34305090","582815","101962380"
"2023/04/05","258867085","3026985","43534150","13020075","318448295"
"2023/04/04","8639890","420485","24701890","15143185","48905450"
"2023/04/03","24848720","9874220","33412690","60509695","128645325"
"2023/03/31","20931020","0","74350025","4541460","99822505"
"2023/03/30","8640935","4450","50732955","1343965","60722305"
"2023/03/29","15701185","0","79859390","0","95560575"
"2023/03/28","50397925","685620","48925700","19055300","119064545"
"2023/03/27","89267085","5493510","158301855","1965660","255028110"
"2023/03/24","5280500","781805","77756825","48895","83868025"
"2023/03/23","47066010","2255370","76832675","28082815","154236870"
"2023/03/22","20283925","10185770","40707325","68345","71245365"
"2023/03/21","11500575","1050385","48590655","459000","61600615"
"2023/03/20","15073430","59463675","253272830","18572420","346382355"
"2023/03/17","37730695","613460","95440380","1929920","135714455"
"2023/03/16","24399090","305915","54979615","8938955","88623575"
"2023/03/15","22817690","1990000","13391635","5001850","43201175"
"2023/03/14","56348860","1234875","93481195","12362185","163427115"
"2023/03/13","22808205","916880","60171285","1579390","85475760"
"2023/03/10","10840860","605120","27039135","0","38485115"
"2023/03/09","5906630","691980","23420560","0","30019170"
"2023/03/08","52478990","786125","16490790","0","69755905"
"2023/03/07","65454555","5328185","52056920","13635500","136475160"
"2023/03/06","85831815","569815","89857480","2595720","178854830"
"2023/03/03","57209685","14270","33200925","15838350","106263230"
"2023/03/02","90398470","2292605","180394255","1102850","274188180"
"2023/02/28","4476345","755665","24933005","0","30165015"
"2023/02/27","18470880","1241990","105025160","9933690","134671720"
"2023/02/24","31061720","5932590","296899860","9626670","343520840"
"2023/02/23","849110","678450","171183700","17684120","190395380"
"2023/02/22","3466870","678150","84857630","0","89002650"
"2023/02/21","46000330","1305800","77701580","0","125007710"
"2023/02/20","26690310","702700","64500990","1450780","93344780"
"2023/02/17","19324620","603600","118937960","59452410","198318590"
"2023/02/16","15833120","624340","46281940","4931700","67671100"
"2023/02/15","35448295","461840","121896965","355090","158162190"
"2023/02/14","14289290","20080","124214580","6138450","144662400"
"2023/02/13","37375840","20120","118358035","3978740","159732735"
"2023/02/10","21291150","20080","33192980","5050","54509260"
"2023/02/09","15097470","5010","125221010","3486820","143810310"
"2023/02/08","30111560","781200","59313000","15743620","105949380"
"2023/02/07","15380430","0","66025690","4865910","86272030"
"2023/02/06","31251880","5040","34193310","934250","66384480"
"2023/02/03","77065760","5060","171793690","13259310","262123820"
"2023/02/02","39337640","1049180","37733160","17838280","95958260"
"2023/02/01","61206985",,"68809320","2049595","132065900"
"2023/01/31","54076520","253995","121648565","11605325","187584405"
"2023/01/30","50889890","7329320","116059685","22479920","196758815"
"2023/01/27","4077350","10135180","149377100","5922150","169511780"
"2023/01/26","13995380","207770","110089110","0","124292260"
"2023/01/25","16867600","508400","170817240","20712160","208905400"
"2023/01/20","55966480","1962850","140251500","47548950","245729780"
"2023/01/19","17157610","16774690","59932110","4845720","98710130"
"2023/01/18","88919810","24665000","150112850","42747345","306445005"
"2023/01/17","83776600","54464220","53663100","20049690","211953610"
"2023/01/16","190223595","3519975","306174255","34832610","534750435"
"2023/01/13","87821125","2012000","102821505","38321790","230976420"
"2023/01/12","161973205","2008000","72869205","28106395","264956805"
"2023/01/11","71097270","1997990","39619360","5331270","118045890"
"2023/01/10","51222935","2621250","75581265","2308740","131734190"
"2023/01/09","46248995","2019835","87782310","21245325","157296465"
"2023/01/06","138875805","2010000","27015365","875080","168776250"
"2023/01/05","227879775","2005605","48955400","18289155","297129935"
"2023/01/04","53884015","1954840","48905205","11628055","116372115"
"2023/01/03","28818760","1951830","80491705","1879300","113141595"
"2023/01/02","48105505","1944855","89362655","587990","140001005"
"2022/12/29","69772455","1956205","24562710","2060660","98352030"
"2022/12/28","101590700","1924795","34523360","2890085","140928940"
"2022/12/27","19790200","1903000","30614755","376040","52683995"
"2022/12/26","39123120","1909500","17993430","1272155","60298205"
"2022/12/23","64729615","1889490","56516670","13852170","136987945"
"2022/12/22","49564275","1884670","25327085","11781015","88557045"
"2022/12/21","36718800","1872670","52412990","7164765","98169225"
"2022/12/20","67042165","11214670","71166105","4441160","153864100"
"2022/12/19","46983300","14025","53531120","1166215","101694660"
"2022/12/16","66978815",,"27574145","75843630","170396590"
"2022/12/15","15488795","0","14925980","1153160","31567935"
"2022/12/14","2187145","4535","55550960","5386805","63129445"
"2022/12/13","58714900","997815","32886905","492655","93092275"
"2022/12/12","51252350","1534520","26952205","0","79739075"
"2022/12/09","35548990","4630","52306035","2800840","90660495"
"2022/12/08","51999495","32230","32566465","3946480","88544670"
"2022/12/07","60756555","9190","37066500","4240225","102072470"
"2022/12/06","60284355","0","118426055","16029320","194739730"
"2022/12/05","13627875","0","47333740","2388005","63349620"
"2022/12/02","23668100","0","121687395","13095860","158451355"
"2022/12/01","9026410","0","71079340","5144465","85250215"
"2022/11/30","13783540","0","40690320","6382135","60855995"
"2022/11/29","19582970","0","49840315","2920085","72343370"
"2022/11/28","35385475","0","73057660","602560","109045695"
"2022/11/25","34407885","1003500","63730350","5436140","104577875"
"2022/11/24","29628435","0","37060630","4476650","71165715"
"2022/11/23","10192645","17960","29743660","2515220","42469485"
"2022/11/22","83758870","307790","160854285","58327990","303248935"
"2022/11/21","41753955","0","18054470","0","59808425"
"2022/11/18","48068865","9230","18928145","482000","67488240"
"2022/11/17","62088295","4610","18220040","2323735","82636680"
"2022/11/16","48168125","20031710","24286160","208420","92694415"
"2022/11/15","41845115","4590","13176610","0","55026315"
"2022/11/14","14163140","0","22891260","685375","37739775"
"2022/11/11","159772820",,"77537765","85653760","322964345"
"2022/11/10","28367810","280960","29118065","0","57766835"
"2022/11/09","36763470",,"17909240","6578790","61251500"
"2022/11/08","11129050","43572265","78801700","23529525","157032540"
"2022/11/07","22884725","4889985","38532185","14077155","80384050"
"2022/11/04","49300455","3231000","35062515","3038490","90632460"
"2022/11/03","38222435","8760","41791520","100855","80123570"
"2022/11/02","28638985","844220","21077085","18434590","68994880"
"2022/11/01","41220830",,"31511180","3255370","75987380"
"2022/10/31","37088680","6354665","51659800","5977280","101080425"
"2022/10/28","63857925","28417550","85475370","24105675","201856520"
"2022/10/27","75186670","22379165","126853255","17762335","242181425"
"2022/10/26","167296015","10586110","130080695","95660090","403622910"
"2022/10/25","42767735","0","28116555","21595925","92480215"
"2022/10/24","100665760","5060275","94782510","34478245","234986790"
"2022/10/21","71570355","0","89796970","9160090","170527415"
"2022/10/20","32833485","4538020","49188795","90422660","176982960"
"2022/10/19","87749600","26945225","96757250","14516750","225968825"
"2022/10/18","63779110","9858260","100729735","10437350","184804455"
"2022/10/17","38219120","3960","175376290","944565","214543935"
"2022/10/14","40220420","3595690","109050475","25771585","178638170"
"2022/10/13","41036165","24575","93427100","91495000","225982840"
"2022/10/12","51267480","53872350","55518885","17067525","177726240"
"2022/10/11","127478355","57587340","195145260","31498645","411709600"
"2022/10/07","107473360","3103480","96231585","7844890","214653315"
"2022/10/06","47016370","12605","379487595","56791475","483308045"
"2022/10/05","81019610","4301880","206912015","17450730","309684235"
"2022/10/04","61092335","998640","126869250","4178455","193138680"
"2022/09/30","67865985","22035","105580210","9524350","182992580"
"2022/09/29","24386085","1506390","101097270","7375535","134365280"
"2022/09/28","39985205","12107995","162352780","27169500","241615480"
"2022/09/27","68642500","0","180475990","16127955","265246445"
"2022/09/26","44011980","9692315","83412405","2064225","139180925"
"2022/09/23","49233250","9425","60100360","84720","109427755"
"2022/09/22","121236985","4831340","41245380","33082160","200395865"
"2022/09/21","38761545","4855000","27108345","41216640","111941530"
"2022/09/20","9120990","240000","29174860","26948805","65484655"
"2022/09/19","30430540","0","2925620","62167720","95523880"
"2022/09/16","16133770","11890660","45190155","15248355","88462940"
"2022/09/15","80582845","2600910","89892410","1169980","174246145"
"2022/09/14","9357980","651525","44810635","4336635","59156775"
"2022/09/13","20885250","0","117581180","4652775","143119205"
"2022/09/08","35307570","4785","94484680","15806040","145603075"
"2022/09/07","60837120","5509940","34325195","17772455","118444710"
"2022/09/06","39717030","3959100","57517535","16081340","117275005"
"2022/09/05","32127405","4840000","29101110","1470150","67538665"
"2022/09/02","35346620","28545125","20907290","0","84799035"
"2022/09/01","80316840","4839860","56698155","1714635","143569490"
"2022/08/31","38574980",,"77501740","180990","116257710"
"2022/08/30","136057555","3570505","198875120","3965820","342469000"
"2022/08/29","222420455","5031000","237952735","73607355","539011545"
"2022/08/26","190100730","25307480","110161900","870390","326440500"
"2022/08/25","74644040","0","94022890","3629110","172296040"
"2022/08/24","73339130","0","122904700","13792440","210036270"
"2022/08/23","174670460","22517800","227901760","13806130","438896150"
"2022/08/22","56916880","0","103224840","150220","160291940"
"2022/08/19","78040120","0","121894310","20115700","220050130"
"2022/08/18","36330030","5110","86704070","48730100","171769310"
"2022/08/17","225703680","0","142643990","31607450","399955120"
"2022/08/16","90163110","2525040","144361830","134184060","371234040"
"2022/08/12","234175510","2520000","103498370","35357030","375550910"
"2022/08/11","81364320","4536000","152730480","16950390","255581190"
"2022/08/10","130359170","998790","42507040","593280","174458280"
"2022/08/09","43111630","5150","28210640","1151290","72478710"
"2022/08/08","132065380","0","81149400","37452520","250667300"
"2022/08/05","287694340","5160","47870810","35311820","370882130"
"2022/08/04","32946840","10240","53345900","3527210","89830190"
"2022/08/03","531894420","5257950","105247440","461040","642860850"
"2022/08/02","55977740","0","48174040","2759590","106911370"
"2022/08/01","61916130","7800000","190373990","1954880","262045000"
"2022/07/29","81526720","5255360","74699095","81405585","242886760"
"2022/07/28","117210370","4840","117352725","81968110","316536045"
"2022/07/27","27337090","16710150","174918260","24515925","243481425"
"2022/07/26","55742340","73937220","180658740","10639825","320978125"
"2022/07/25","26467025","64478720","88718025","3745320","183409090"
"2022/07/22","42034250","124726425","84887770","233200","251881645"
"2022/07/21","38078320","117555270","102968410","9398325","268000325"
"2022/07/20","33636510","383651835","37845360","11637685","466771390"
"2022/07/19","79075550","91232540","116325600","46880715","333514405"
"2022/07/18","8442105","114619225","36524980","12872635","172458945"
"2022/07/15","57272485","42847850","95151705","2177345","197449385"
"2022/07/14","26165635","40500190","87603745","1223915","155493485"
"2022/07/13","43463475","36373935","236316795","48680070","364834275"
"2022/07/12","216204160","60844695","472528575","66636040","816213470"
"2022/07/11","94314760","64352560","91395590","19122550","269185460"
"2022/07/08","76824770","74254020","33857940","2512220","187448950"
"2022/07/07","33114120","9306150","22586710","2245820","67252800"
"2022/07/06","121003170","16717050","27480300","9684950","174885470"
"2022/07/05","39690350","5140000","50056370","32338300","127225020"
"2022/07/04","86782640","10139930","131342290","35404745","263669605"
"2022/07/01","76796480","23355000","31183240","4993190","136327910"
"2022/06/30","25768160","5250000","41078390","6796710","78893260"
"2022/06/29","57338060","79554450","39651440","44834860","221378810"
"2022/06/28","71078600","98586570","50982050","46533960","267181180"
"2022/06/27","76634410","78850300","42417090","28690240","226592040"
"2022/06/24","93422060","81989670","93001960","91288800","359702490"
"2022/06/23","49127470","145908370","100989970","67172360","363198170"
"2022/06/22","100741220","63530920","207984540","48811430","421068110"
"2022/06/21","292276420","4099820","119609380","88045690","504031310"
"2022/06/20","818911050","32168980","131201460","194430330","1176711820"
"2022/06/17","48873930","14461870","41281080","3520020","108136900"
"2022/06/16","37163350","36573560","172827880","17896760","264461550"
"2022/06/15","83262270","19069420","69541910","5633930","177507530"
"2022/06/14","136512730","36420810","74186260","47966080","295085880"
"2022/06/13","98906580","20068300","42068280","40449740","201492900"
"2022/06/10","7755810","65670","21179420","13485650","42486550"
"2022/06/09","55730110","17970000","135218230","26887340","235805680"
"2022/06/08","44525680","0","11948420","6097650","62571750"
"2022/06/07","33540610","0","22540340","15737100","71818050"
"2022/06/03","92545360","0","21827260","86351380","200724000"
"2022/06/02","41967060","0","31727900","44630890","118325850"
"2022/05/31","47985760",,"13941920","161896160","223823840"
"2022/05/30","63270580","10200000","52969640","5620370","132060590"
"2022/05/27","40816560","0","31672690","41990","72531240"
"2022/05/26","125514860","0","13981770","0","139496630"
"2022/05/25","77057500","0","76876740","23664110","177598350"
"2022/05/24","102964910","5910","6553920","13887150","123411890"
"2022/05/23","57808450","19833460","107406160","17248080","202296150"
"2022/05/20","47129250","23676460","45558040","39164520","155528270"
"2022/05/19","150422310","26072220","40454610","29107230","246056370"
"2022/05/18","197115470","40968750","164144330","15779240","418007790"
"2022/05/17","260337200","54067360","40695210","3692620","358792390"
"2022/05/16","81644380","2974400","13918940","0","98537720"
"2022/05/13","331236500","34284930","26504640","39403990","431430060"
"2022/05/12","171232660","9531170","26940000","31547750","239251580"
"2022/05/11","101473500","5023500","133673640","23735680","263906320"
"2022/05/10","68847670","68769190","122573070","47592180","307782110"
"2022/05/09","62071620","17766220","102397360","1697610","183932810"
"2022/05/06","121263850","28129080","131528430","2353610","283274970"
"2022/05/04","77800390","38400960","89094460","699970","205995780"
"2022/05/03","170499150","51870400","161758170","24806430","408934150"
"2022/05/02","193303720","0","176245810","11258300","380807830"
"2022/04/29","282501860","73224330","20378710","19620310","395725210"
"2022/04/28","178000380","6100000","86739300","26124990","296964670"
"2022/04/27","241122920","8331520","70017910","156957860","476430210"
"2022/04/26","179462070","0","40432270","25597350","245491690"
"2022/04/25","315315250","0","296574550","90944250","702834050"
"2022/04/22","97628720","0","104350700","22808120","224787540"
"2022/04/21","105428170","18258240","86071360","43480090","253237860"
"2022/04/20","93164510","0","139183070","23994350","256341930"
"2022/04/19","88586020","0","343468860","54390000","486444880"
"2022/04/18","146727090","24522740","537296380","70169200","778715410"
"2022/04/15","127857100","0","102703100","26921370","257481570"
"2022/04/14","252224880","0","106533990","52591190","411350060"
"2022/04/13","114958290","10010880","236031310","49433590","410434070"
"2022/04/12","262376430","0","78076110","64717580","405170120"
"2022/04/11","165574060","0","98190820","37534040","301298920"
"2022/04/08","397922960","14632470","71961290","127100930","611617650"
"2022/04/07","416562040","0","78913760","20628500","516104300"
"2022/04/06","206455230","0","31582970","35082160","273120360"
"2022/04/05","155668670","35823600","93524200","27835970","312852440"
"2022/04/04","112103220","15968500","61638620","16569160","206279500"
"2022/04/01","38201200","31931760","40317520","20072890","130523370"
"2022/03/31","111548740","20362730","49498390","7315400","188725260"
"2022/03/30","91006610","15338290","21432630","16010140","143787670"
"2022/03/29","143499350","14732410","75705190","19656350","253593300"
"2022/03/28","116532650","22088210","76458700","1584030","216663590"
"2022/03/25","64338920","18122160","102542500","26813140","211816720"
"2022/03/24","40920610","58300","30957970","64786920","136723800"
"2022/03/23","138747040","44014160","59185290","0","241946490"
"2022/03/22","176055960","176100","120896260","61958050","359086370"
"2022/03/21","60381920","4227890","17674480","17240860","99525150"
"2022/03/18","25869990","0","37699670","138352510","201922170"
"2022/03/17","152948650","3852180","10230020","19592410","186623260"
"2022/03/16","352202050","12776340","141626900","37905630","544510920"
"2022/03/15","273608230","321750","34199480","31164850","339294310"
"2022/03/14","258899250","10267770","40490850","129069540","438727410"
"2022/03/11","131618280","48315600","43060410","21435190","244429480"
"2022/03/10","197212400","10063000","21295390","14071010","242641800"
"2022/03/08","210613470","9668040","21894900","1209860","243386270"
"2022/03/07","112675850","8710160","35733710","978790","158098510"
"2022/03/04","178846190","9645400","8038250","27510560","224040400"
"2022/03/03","222820280","519700","42693940","20006130","286040050"
"2022/03/02","208014570","5710000","52006880","793230","266524680"
"2022/02/28","65515980","68760","29189410","1696080","96470230"
"2022/02/25","223527670","27370000","282765460","224531070","758194200"
"2022/02/24","119130090","134827550","340164140","92408160","686529940"
"2022/02/23","105204150","318743220","164718260","125220530","713886160"
"2022/02/22","134521950","351818400","386016840","13506940","885864130"
"2022/02/21","124272160","66388000","101487640","125974780","418122580"
"2022/02/18","24748340","7107800","64977250","17956400","114789790"
"2022/02/17","206884380","58800","224007870","159773550","590724600"
"2022/02/16","169222360","58500","62676570","149080860","381038290"
"2022/02/15","137555250","11670","117379920","64881640","319828480"
"2022/02/14","213359890","174100","79546000","100210540","393290530"
"2022/02/11","139113160","0","157784840","72162400","369060400"
"2022/02/10","158191070","57600","53202550","53550910","265002130"
"2022/02/09","165553880","607080","172314180","104839880","443315020"
"2022/02/08","276868350","25730490","120983050","170308170","593890060"
"2022/02/07","280915600","66129150","266865520","362947030","976857300"
"2022/02/04","172623570","27251500","262332500","174564500","636772070"
"2022/02/03","269282840","51817240","161711020","86884830","569695930"
"2022/01/28","96576170","62945080","110470730","13545790","283537770"
"2022/01/27","191912440","5660","29641170","33608580","255167850"
"2022/01/26","268241430","5633680","74074660","53437600","401387370"
"2022/01/25","128572760","22430000","204946400","33600230","389549390"
"2022/01/24","190530110","5943800","81394610","54337020","332205540"
"2022/01/21","127918380","0","23575060","8409440","159902880"
"2022/01/20","101308900","28712000","91640520","17784630","239446050"
"2022/01/19","38220650","0","42989310","10004510","91214470"
"2022/01/18","69757790","42991070","89024540","27553570","229326970"
"2022/01/17","104272650","9020000","125023190","3305250","241621090"
"2022/01/14","34747080","0","89662650","68160","124477890"
"2022/01/13","197258130","45280000","101397260","20852230","364787620"
"2022/01/12","114741580","10890220","200757430","9364390","335753620"
"2022/01/11","126444940","17085700","179796350","37448720","360775710"
"2022/01/10","232989750","35690820","76782920","40441480","385904970"
"2022/01/07","167427790","20654000","232623470","18737820","439443080"
"2022/01/06","122071900","2885000","113242400","28651430","266850730"
"2022/01/05","194592560","11600000","48118070","16493860","270804490"
"2022/01/04","326347020","66331800","404233020","60320970","857232810"
"2022/01/03","153809970","0","88621490","2156480","244587940"
"2021/12/30","107431520","0","45952780","13037210","166421510"
"2021/12/29","106541890","0","27535920","9215970","143293780"
"2021/12/28","113202520","11610000","44947160","1696530","171456210"
"2021/12/27","105274600","1284010","184667850","8480720","299707180"
"2021/12/24","64983920","2047500","109571730","5840","176608990"
"2021/12/23","18488570","17391840","73817210","13409600","123107220"
"2021/12/22","8866240","24791090","25311060","869760","59838150"
"2021/12/21","19645970","11505770","36819650","0","67971390"
"2021/12/20","33235790","17240000","81756690","0","132232480"
"2021/12/17","92739130","0","41157180","69430100","203326410"
"2021/12/16","67247020","1152000","11426270","8250410","88075700"
"2021/12/15","43811130","2855000","24070440","28650","70765220"
"2021/12/14","38473610","0","11592730","28700","50095040"
"2021/12/13","54679530","938080","46102690","216980","101937280"
"2021/12/10","43303750","8590000","38337740","0","90231490"
"2021/12/09","10620680","16477960","43759860","31948840","102807340"
"2021/12/08","69617240","28600000","90524350","1056350","189797940"
"2021/12/07","60450720","12269000","140129080","161560","213010360"
"2021/12/06","64227740","3118240","94529390","17249880","179125250"
"2021/12/03","77488730","12524600","73037400","35895460","198946190"
"2021/12/02","8874590","1003980","59825130","81999380","151703080"
"2021/12/01","79505010","19945330","53425750","46100610","198976700"
"2021/11/30","145758920","6765130","403203840","14493250","570221140"
"2021/11/29","199266830","10961930","45919780","104400","256252940"
"2021/11/26","108933260","1002060","124497820","6277940","240711080"
"2021/11/25","279675230","2152580","74337350","0","356165160"
"2021/11/24","194317930","15149930","119669200","117979110","447116170"
"2021/11/23","24459800","9145470","28833930","25527880","87967080"
"2021/11/22","162580330","18598850","115492390","5581710","302253280"
"2021/11/19","107849920","13801270","103026940","98669240","323347370"
"2021/11/18","100103960","25608920","87258330","82188240","295159450"
"2021/11/17","200003600","109666320","187061830","48633880","545365630"
"2021/11/16","150518830","33596350","110216220","89052560","383383960"
"2021/11/15","185527090","7330090","44194740","8435220","245487140"
"2021/11/12","17476640","1082830","57249520","18607430","94416420"
"2021/11/11","283646720","1004480","74197360","70806810","429655370"
"2021/11/10","211090020","1015490","94397990","73009180","379512680"
"2021/11/09","294001590","128207780","102891130","82257380","607357880"
"2021/11/08","197105640","60061200","240296430","97298960","594762230"
"2021/11/05","104117960","39751260","71382130","29655520","244906870"
"2021/11/04","110529380","44938890","127424400","60594290","343486960"
"2021/11/03","102701970","34281770","213712500","61372860","412069100"
"2021/11/02","103193140","1005480","218351510","103463600","426013730"
"2021/11/01","104710970","0","136885750","72431860","314028580"
"2021/10/29","191925960","17573100","104162590","8374860","322036510"
"2021/10/28","66493700","16678350","40719690","6690700","130582440"
"2021/10/27","76938150","0","70804920","3756980","151500050"
"2021/10/26","126081510","23794680","47803990","87600","197767780"
"2021/10/25","146619020","2900000","29103140","8431220","187053380"
"2021/10/22","150874120","1002760","172721960","11131220","335730060"
"2021/10/21","319319210","12736200","227619230","184488440","744163080"
"2021/10/20","109763020","8715000","160107830","96190520","374776370"
"2021/10/19","231609150","1872000","236392380","341257720","811131250"
"2021/10/18","186376300","6832000","158033330","89869120","441110750"
"2021/10/15","221625300","9337000","79893460","99979870","410835630"
"2021/10/14","173868300","5680000","42795780","26278760","248622840"
"2021/10/13","109522060","87547500","42077680","39650520","278797760"
"2021/10/12","102154470","238995270","55550390","52793680","449493810"
"2021/10/08","143823120","0","59769310","3526380","207118810"
"2021/10/07","103394910","262234480","41055560","40456210","447141160"
"2021/10/06","219169670","16920000","150170010","17744660","404004340"
"2021/10/05","161737320","6208290","85071510","8400050","261417170"
"2021/10/01","132429310","1825394180","46051790","24425180","2028300460"
"2021/09/30","118913540","29112340","89615100","2789640","240430620"
"2021/09/29","109236620","306746960","162513660","144690560","723187800"
"2021/09/28","55589070","980917160","98968920","348710490","1484185640"
"2021/09/27","40976030","40112800","255737200","56612030","393438060"
"2021/09/24","114042450","0","501637910","148770660","764451020"
"2021/09/23","301302850","0","225031120","73496270","599830240"
"2021/09/17","111133570","23232740","170036610","20586680","324989600"
"2021/09/16","83818170","1004640","77200040","48410000","210432850"
"2021/09/15","114415790","11246640","71429950","24906500","221998880"
"2021/09/14","109385470","0","107468050","37276310","254129830"
"2021/09/13","136351210","1002740","60312510","30475240","228141700"
"2021/09/10","29347890","6550800","122479990","36170610","194549290"
"2021/09/09","40340490","9250960","222182830","47249620","319023900"
"2021/09/08","31479420","5570000","74230580","20219400","131499400"
"2021/09/07","93854780","11150000","160767500","14237130","280009410"
"2021/09/06","129345480","8272590","300817560","84734980","523170610"
"2021/09/03","164349480","26686180","171483950","16946920","379466530"
"2021/09/02","34389800","5918640","84201890","6584470","131094800"
"2021/09/01","89976980","24763800","315269090","0","430009870"
"2021/08/31","56039180","6128200","80454300","6876490","149498170"
"2021/08/30","201865010","86088340","416439100","48868300","753260750"
"2021/08/27","280880160","0","363375720","98094580","742350460"
"2021/08/26","123433640","0","117250470","25418820","266102930"
"2021/08/25","61142370","0","87539330","38477130","187158830"
"2021/08/24","33252520","187480600","104387990","24715710","349836820"
"2021/08/23","102731660","152601720","127672480","165122400","548128260"
"2021/08/20","122886400","39110000","347186350","83606000","592788750"
"2021/08/19","149770880","8395000","89817140","11093120","259076140"
"2021/08/18","129427840","12870000","74790000","48580490","265668330"
"2021/08/17","29269120","1002740","101667220","10328770","142267850"
"2021/08/13","64768170","5560000","185164080","62142240","317634490"
"2021/08/12","235208130","0","94640550","138823920","468672600"
"2021/08/11","115279770",,"79212360","21495180","215987310"
"2021/08/10","108542190","0","91307730","11142870","210992790"
"2021/08/09","96701210","144560","124544110","2985740","224375620"
"2021/08/06","164842160","6633870","84728790","36530510","292735330"
"2021/08/05","106910060","1665830","192661990","12617850","313855730"
"2021/08/04","52327310","285200","52307740","605890","105526140"
"2021/08/03","48143970","1004550","68002700","11737600","128888820"
"2021/08/02","159551120","1052730","43208260","0","203812110"
"2021/07/30","212963440","1000800","116356420","51598340","381919000"
"2021/07/29","157893090","0","40310820","34219470","232423380"
"2021/07/28","110494890","0","8801330","33095230","152391450"
"2021/07/27","114298460","5530000","81391710","5580","201225750"
"2021/07/26","191437720","11100000","144250240","12146300","358934260"
"2021/07/23","294412650","12452990","155677480","8707580","471250700"
"2021/07/22","134175490","22120000","133426460","27856520","317578470"
"2021/07/21","51769470","0","141454300","29831220","223054990"
"2021/07/20","29213470","55200000","185993050","28619170","299025690"
"2021/07/19","144867930","3193010","158891850","11823970","318776760"
"2021/07/16","52224450","28854550","170962560","11832600","263874160"
"2021/07/15","149568100","0","123229600","5593900","278391600"
"2021/07/14","79618730","16433100","107562650","10662800","214277280"
"2021/07/13","130157260","15443420","66291160","1833010","213724850"
"2021/07/12","117975010","11230000","190171170","3262670","322638850"
"2021/07/09","289381450","11666200","183225780","39540110","523813540"
"2021/07/08","54957690","62656870","296692610","2267320","416574490"
"2021/07/07","215107530","85216000","142930470","2759010","446013010"
"2021/07/06","43430680","286753110","112771510","20563380","463518680"
"2021/07/05","210177540","1000050","97208460","32963600","341349650"
"2021/07/02","86695000","16890000","99540020","12232230","215357250"
"2021/07/01","128679200","0","130037580","10437540","269154320"
"2021/06/30","19318500","0","144359210","5640","163683350"
"2021/06/29","20250530","0","266963490","33970","287247990"
"2021/06/28","158209620","84278280","559499000","31468090","833454990"
"2021/06/25","63402240","28645400","84875990","4634250","181557880"
"2021/06/24","40062530","27600000","122897540","18151750","208711820"
"2021/06/23","131069100","543623070","102629580","1816920","779138670"
"2021/06/22","159611180","244762500","117260390","11947280","533581350"
"2021/06/21","139934660","8661960","189583160","59617990","397797770"
"2021/06/18","139148350","9277200","240622230","15065840","404113620"
"2021/06/17","493894480","44020000","296040350","137708570","971663400"
"2021/06/16","101967580","37396210","350890480","21386200","511640470"
"2021/06/15","208625830","24193100","264084350","24908080","521811360"
"2021/06/14","435811410","31274720","149778590","71798090","688662810"
"2021/06/11","155320660","37551180","253123670","23371630","469367140"
"2021/06/10","135958160","7040970","198850460","35145920","376995510"
"2021/06/09","446278510","83920940","203174390","41310560","774684400"
"2021/06/08","255928240","16000450","126222740","44789180","442940610"
"2021/06/07","591476230","10981580","353374500","116398430","1072230740"
"2021/06/04","531487120","11023650","258635950","150843430","951990150"
"2021/06/03","616531870","0","731130670","199390930","1547053470"
"2021/06/02","649399560","5565960","613056990","127075010","1395097520"
"2021/06/01","765496700","7971000","516932580","279724680","1570124960"
"2021/05/31","361797500","10769700","631710890","130779210","1135057300"
"2021/05/28","611060860","0","421570620","26429280","1059060760"
"2021/05/27","775590410","103165050","904658490","165997120","1949411070"
"2021/05/26","255997880","15360000","404095520","0","675453400"
"2021/05/25","579893950","76650000","346044970","9563800","1012152720"
"2021/05/24","353480760","50779910","648254110","275858080","1328372860"
"2021/05/21","201986060","0","278125430","0","480111490"
"2021/05/20","97533470","254377160","335555890","306566260","994032780"
"2021/05/18","93251160","119102730","696103445","91103230","999560565"
"2021/05/17","61369455","18444500","363720435","2755670","446290060"
"2021/05/14","387622195","0","263651545","52609670","703883410"
"2021/05/13","155889545","852429240","1075030040","179652315","2263001140"
"2021/05/12","251254060","9960000","589647370","145522165","996383595"
"2021/05/11","253711750","59740780","309248715","37660695","660361940"
"2021/05/10","91760100","9980000","519457270","74668790","695866160"
"2021/05/07","181215565","4985000","143113640","21984755","351298960"
"2021/05/06","119142725","29710460","467338320","87926885","704118390"
"2021/05/04","167033780","109560015","130236590","202401400","609231785"
"2021/05/03","20572250","52931595","386765185","23579025","483848055"
"2021/04/30","67899405","1984000","137767960","13884590","221535955"
"2021/04/29","160222040","30209390","92478260","15849300","298758990"
"2021/04/28","88057755","21112560","403589550","0","512759865"
"2021/04/27","150654140","54895000","343620870","22614975","571784985"
"2021/04/26","181002350","49959345","537302805","52749120","821013620"
"2021/04/23","80204840","100641160","317011850","24362860","522220710"
"2021/04/22","303608065","58912880","280134060","0","642655005"
"2021/04/21","282826075","7979500","326317215","58553060","675675850"
"2021/04/20","272797680","9970000","527584975","44210800","854563455"
"2021/04/19","155493125","14999760","324856810","156683010","652032705"
"2021/04/16","92575700","6656550","294119745","4080370","397432365"
"2021/04/15","228456210","49700000","332014295","169641100","779811605"
"2021/04/14","126567965","0","103745820","5177120","235490905"
"2021/04/13","383502935","0","305238535","31159570","719901040"
"2021/04/12","124126200","12337500","289570750","101589305","527623755"
"2021/04/09","78949395","712675","169272410","20099350","269033830"
"2021/04/08","40079385",,"335523625","3924890","379527900"
"2021/04/07","49248805","40598520","258000740","8519030","356367095"
"2021/04/06","137467020","95301300","449827905","26813780","709410005"
"2021/04/05","64797950","2450000","440645830","64696060","572589840"
"2021/04/02","160961835","0","374646970","46951310","582560115"
"2021/04/01","165976290","4880000","214463675","6869395","392189360"
"2021/03/31","109424010","34133000","511517070","48317215","703391295"
"2021/03/30","85024660","48900000","539682445","8322980","681930085"
"2021/03/29","160280060","0","813081880","211395935","1184757875"
"2021/03/26","322616150","2397500","199102960","31760270","555876880"
"2021/03/25","683132770","25237635","1518630660","22012470","2249013535"
"2021/03/24","6285395",,"40045440","4875","46335710"
"2021/03/23","111916090","0","132504290","0","244420380"
"2021/03/22","82661820","0","65690320","580800","148932940"
"2021/03/19","74503625","50797530","40060890","170759155","336121200"
"2021/03/18","19187635","2392500","63786570","9108465","94475170"
"2021/03/17","55320435","2390000","105519335","15677495","178907265"
"2021/03/16","41052595","2390000","75326315","8449410","127218320"
"2021/03/15","43638570","96023480","49499910","11559890","200721850"
"2021/03/12","29181330",,"47535505","6994590","83711425"
"2021/03/11","85460705","2836500","59059415","5119000","152475620"
"2021/03/10","61244445","0","36581345","5918520","103744310"
"2021/03/09","52061485","7336700","71006960","42847305","173252450"
"2021/03/08","48278620","999580","143658115","5870345","198806660"
"2021/03/05","35475630","6153875","149579340","0","191208845"
"2021/03/04","43586405","3315000","196688330","297360","243887095"
"2021/03/03","71289265","475500","97647110","0","169411875"
"2021/03/02","20060345","16521500","201266505","34794570","272642920"
"2021/02/26","60437675","0","193106635","25150440","278694750"
"2021/02/25","125655660","8701650","451516165","27567035","613440510"
"2021/02/24","99625805","48650000","290820635","10763440","449859880"
"2021/02/23","20656840","48700000","309047735","0","378404575"
"2021/02/22","28148360","0","276066875","0","304215235"
"2021/02/19","24657530","0","246571035","7746495","278975060"
"2021/02/18","71885285","0","224070560","0","295955845"
"2021/02/17","226065245","1946000","443417660","1331000","672759905"
"2021/02/16","59712450","63765","539948835","12913300","612638350"
"2021/02/15","126447955","1412040","369914380","42580360","540354735"
"2021/02/10","19716785","1963500","627342345","20503770","669526400"
"2021/02/09","137637675","1467000","161884895","76473500","377463070"
"2021/02/08","150716860","0","465431985","106873735","723022580"
"2021/02/05","37319205","48550000","759220410","53714515","898804130"
"2021/02/04","108252870","1212500","125753920","13845790","249065080"
"2021/02/03","176861340","0","165982650","13140320","355984310"
"2021/02/02","148450800","0","218784740","14228120","381463660"
"2021/02/01","22395100","0","162178215","5948115","190521430"
"2021/01/29","58872905","498160","152874885","7473785","219719735"
"2021/01/28","261787640","0","200178720","11304800","473271160"
"2021/01/27","79756960","999440","148398870","1790400","230945670"
"2021/01/26","169483645","0","218674210","40506530","428664385"
"2021/01/25","132003670","7992035","203520670","35524475","379040850"
"2021/01/22","128448625","114283095","96834780","23209295","362775795"
"2021/01/21","90322990","25457000","122852140","9397185","248029315"
"2021/01/20","231679100","47000000","163445790","23324785","465449675"
"2021/01/19","193479975","8601000","85601790","249200","287931965"
"2021/01/18","77658105","1464840","152696125","2209000","234028070"
"2021/01/15","38781395","11762500","327209315","28929540","406682750"
"2021/01/14","48207220","7783485","212520920","10308865","278820490"
"2021/01/13","59210445","4695000","50190635","15990900","130086980"
"2021/01/12","36890740","3599750","262153085","49294615","351938190"
"2021/01/11","142567555","52405450","339560025","1525675","536058705"
"2021/01/08","120284970","7533000","403723110","10380320","541921400"
"2021/01/07","64303860","5668000","247956015","1364700","319292575"
"2021/01/06","43866985","52310195","204505610","693500","301376290"
"2021/01/05","262358395","10406000","162861840","65939865","501566100"
"2021/01/04","418848970","0","197094225","46644865","662588060"
"2020/12/30","72541505","0","138255255","3011900","213808660"
"2020/12/29","75308585","16160100","234289605","119385890","445144180"
"2020/12/28","102128935","14200000","454809050","46012100","617150085"
"2020/12/24","29893280","0","95028670","21288440","146210390"
"2020/12/23","38529275","0","120899770","16183555","175612600"
"2020/12/22","49486990","47250000","212457670","5608490","314803150"
"2020/12/21","29548670","47373330","204140365","53432085","334494450"
"2020/12/18","39632875","18900000","551905995","756484255","1366923125"
"2020/12/17","84318310","5014900","192840880","306537100","588711190"
"2020/12/16","50478960","0","241188370","191364235","483031565"
"2020/12/15","18069995","0","67101870","73181990","158353855"
"2020/12/14","198276665","42615000","204520080","13885360","459297105"
"2020/12/11","63726775","995400","304634455","0","369356630"
"2020/12/10","13190455","995885","306291105","4740","320482185"
"2020/12/09","56462315","999600","118913400","109800","176485115"
"2020/12/08","25568330","0","27272075","0","52840405"
"2020/12/07","104844300","0","217701630","30567935","353113865"
"2020/12/04","22260040","0","329977030","6442190","358679260"
"2020/12/03","68493820","0","364628460","1107645","434229925"
"2020/12/02","83041155","0","241228870","0","324270025"
"2020/12/01","44256660","6484190","258486585","6163750","315391185"
"2020/11/30","189183065",,"199416210","2558990","391158265"
"2020/11/27","17843465","1944000","150622760","0","170410225"
"2020/11/26","90529405",,"236179295","0","326708700"
"2020/11/25","56269850",,"284203965","4870","340478685"
"2020/11/24","85491475",,"254920665","4880000","345292140"
"2020/11/23","155452210",,"130120385","46021170","331593765"
"2020/11/20","234248505","0","355964220","25884005","616096730"
"2020/11/19","33729430","25315560","385086365","10337940","454469295"
"2020/11/18","89283080","14121350","399660865","26997375","530062670"
"2020/11/17","120494770","2440000","224868450","41877290","389680510"
"2020/11/16","282559260","9236700","131015850","17608125","440419935"
"2020/11/13","217090140","4900000","160977115","87396465","470363720"
"2020/11/12","196807865","5389800","147926160","62308955","412432780"
"2020/11/11","49873065","5860020","406938520","56231755","518903360"
"2020/11/10","108905495","9765000","174232815","154441275","447344585"
"2020/11/09","186774500","0","408406660","47437820","642618980"
"2020/11/06","73151540","0","213705315","151413965","438270820"
"2020/11/05","343143070","0","787159730","17189075","1147491875"
"2020/11/04","294170050","14840000","411397920","81857890","802265860"
"2020/11/03","81908825","0","414925300","38461490","535295615"
"2020/11/02","22676550","10992970","449094265","4327075","487090860"
"2020/10/30","250467705","0","696437060","150663075","1097567840"
"2020/10/29","34839080","0","524340980","34504260","593684320"
"2020/10/28","82146840","99942025","516590235","32868615","731547715"
"2020/10/27","519483445","149750000","665423175","72439785","1407096405"
"2020/10/26","236752900","64980010","395164170","72585770","769482850"
"2020/10/23","383645290","209890665","516737340","75706115","1185979410"
"2020/10/22","210180100","73929585","353978610","46357310","684445605"
"2020/10/21","180924830","99898890","369370210","49185570","699379500"
"2020/10/20","245551875","7906550","436705250","25711365","715875040"
"2020/10/19","746838465","435315515","759628065","68839770","2010621815"
"2020/10/16","424889220","1012230","601854295","124448315","1152204060"
"2020/10/15","298172450","0","386568410","88020305","772761165"
"2020/10/14","181510905",,"527130105","38731335","747372345"
"2020/10/13","104313520","3930030","273490605","24697430","406431585"
"2020/10/12","94959005","0","177476090","9788350","282223445"
"2020/10/08","519938695","14050000","597390055","85761820","1217140570"
"2020/10/07","66180240","23856530","171978055","13488465","275503290"
"2020/10/06","48278265","2295000","125522900","7483480","183579645"
"2020/10/05","36920035","1005400","81716300","287205","119928940"
"2020/09/29","48265135","1880235","109200835","8206535","167552740"
"2020/09/28","63672260","0","173915360","1741440","239329060"
"2020/09/25","48889895","497750","238642915","32777545","320808105"
"2020/09/24","95465965","2247500","341995170","40696115","480404750"
"2020/09/23","73939805","7731850","116303155","21727215","219702025"
"2020/09/22","84768050","3225695","130422950","0","218416695"
"2020/09/21","23924430","0","76711905","9694610","110330945"
"2020/09/18","37336680","0","72559395","11598345","121494420"
"2020/09/17","8588025","4470000","166420115","19838160","199316300"
"2020/09/16","84498675","17840000","113090130","28979935","244408740"
"2020/09/15","65643385","14891320","150918110","8642835","240095650"
"2020/09/14","15789340","27789040","250769910","10196310","304544600"
"2020/09/11","22573825","5467920","194439690","13601950","236083385"
"2020/09/10","31327610","996800","137962745",,"170287155"
"2020/09/09","39867605","0","205412790","19058620","264339015"
"2020/09/08","15130775","37264350","114795300","7048735","174239160"
"2020/09/07","19631245","446100","268737680","0","288815025"
"2020/09/04","31846600","995680","249224410","2517480","284584170"
"2020/09/03","55546135","0","250521265",,"306067400"
"2020/09/02","13537975","6420120","514449065",,"534407160"
"2020/09/01","59470385","6240500","455230245",,"520941130"
"2020/08/31","135320100","6295000","398469360","0","540084460"
"2020/08/28","219500755","60511730","386643530","2280000","668936015"
"2020/08/27","112461170","54084800","657288625","12331060","836165655"
"2020/08/26","132245145","0","316494760","24775215","473515120"
"2020/08/25","79362100","0","402559690","4606070","486527860"
"2020/08/24","83189095","0","286571620","0","369760715"
"2020/08/21","132625390","9085000","170077085","9354800","321142275"
"2020/08/20","63506750","55484000","458105160","17855755","594951665"
"2020/08/19","54253070","1818000","208764015","2317980","267153065"
"2020/08/18","168154275","18039000","674259955","8278590","868731820"
"2020/08/14","59338585","23400000","248284965","9374840","340398390"
"2020/08/13","80490360","85489720","600861170","20418985","787260235"
"2020/08/12","532714555","16840710","729286830","64293675","1343135770"
"2020/08/11","103441230","234830195","546005300","52930575","937207300"
"2020/08/10","142216960","89994940","698707030","6067365","936986295"
"2020/08/07","97046805","2663500","377545685","4708110","481964100"
"2020/08/06","200758100","0","475713560","42231475","718703135"
"2020/08/05","146012865","278902200","1153408705","2112975","1580436745"
"2020/08/04","59891615","110014710","1028004080","2274775","1200185180"
"2020/08/03","180202230","46395805","563344600","84723035","874665670"
"2020/07/31","95836335","89200000","528423145","11085300","724544780"
"2020/07/30","172639630","0","556927515","48356295","777923440"
"2020/07/29","245090770","66625000","1297556410","57553955","1666826135"
"2020/07/28","275823900","423925000","735111360","19519080","1454379340"
"2020/07/27","83094465","123054895","240592250","92264760","539006370"
"2020/07/24","252527135","186095670","404292395","3485175","846400375"
"2020/07/23","151041820","237094975","592572430","109927010","1090636235"
"2020/07/22","215082520","383781790","1049812915","50378980","1699056205"
"2020/07/21","38638570","183864855","1468637540","88637520","1779778485"
"2020/07/20","122186340","240863475","2807927430","111133345","3282110590"
"2020/07/17","2358840940","241168420","8441059695","149469540","11190538595"
"2020/07/16","664326940","84503030","34074783170","70185820","34893798960"