일자,기관 합계,기타법인,개인,외국인 합계,전체
"2023/05/04","395787290","8739275","635429895","41554645","1081511105"
"2023/05/03","189761985","187685725","768623730","35198270","1181269710"
"2023/05/02","124247715","428864450","844395310","30705765","1428213240"
"2023/04/28","114389795","96564705","489434845","405341385","1105730730"
"2023/04/27","212977995","335813580","354686545","137249090","1040727210"
"2023/04/26","188346730","86325925","752993890","208660815","1236327360"
"2023/04/25","154693010","454170","952648665","95605570","1203401415"
"2023/04/24","408457360","67527565","936737605","10529200","1423251730"
"2023/04/21","428761600","836605","1397493675","9406925","1836498805"
"2023/04/20","277563095","8820","866660890","192582590","1336815395"
"2023/04/19","352255485","976705","1041061205","72586165","1466879560"
"2023/04/18","262319440","20511835","875468895","370952650","1529252820"
"2023/04/17","332685185","1561385","536098920","225015485","1095360975"
"2023/04/14","305480350","163070735","1104856970","872671655","2446079710"
"2023/04/13","336934355","0","781547790","149814020","1268296165"
"2023/04/12","206738360","78822620","406981450","96590665","789133095"
"2023/04/11","309265760","91430000","547986835","142529530","1091212125"
"2023/04/10","332965015","44775770","689075950","50199365","1117016100"
"2023/04/07","96687685","31947800","310209075","56638760","495483320"
"2023/04/06","313067140","96250","370464210","57475990","741103590"
"2023/04/05","443965350","44389430","498483875","21867820","1008706475"
"2023/04/04","202252205","61234335","333654130","323377755","920518425"
"2023/04/03","489361565","37471850","335462485","205330345","1067626245"
"2023/03/31","587185520","7349635","407532415","333322390","1335389960"
"2023/03/30","291623375","21429295","518524580","36108110","867685360"
"2023/03/29","348392205","55819250","345703365","6147495","756062315"
"2023/03/28","145097750","52649470","627508575","197297680","1022553475"
"2023/03/27","481164695","372053460","1496626090","165196320","2515040565"
"2023/03/24","92456075","0","646937635","56679855","796073565"
"2023/03/23","223568465","64527500","749983205","154558710","1192637880"
"2023/03/22","453189495","44542040","827602210","1716905","1327050650"
"2023/03/21","298536530","32650420","814765000","146999910","1292951860"
"2023/03/20","123115410","88740000","645937795","38092145","895885350"
"2023/03/17","280714705","167269895","408987515","627543280","1484515395"
"2023/03/16","196446040","164812630","222030765","52666855","635956290"
"2023/03/15","226954680","356601465","406038775","46018645","1035613565"
"2023/03/14","410660515","15170800","933501395","140113615","1499446325"
"2023/03/13","256712135","22263380","961372750","288486380","1528834645"
"2023/03/10","663693065","35151545","889119850","12004480","1599968940"
"2023/03/09","162956510","0","643639670","12942990","819539170"
"2023/03/08","178885660","8151895","698083495","13546685","898667735"
"2023/03/07","330995745","13530000","730155685","216597910","1291279340"
"2023/03/06","400678695","22795600","538657355","145545065","1107676715"
"2023/03/03","205604030","1995400","509249125","13423540","730272095"
"2023/03/02","329948315","13067105","1162021180","85854400","1590891000"
"2023/02/28","230431665","110791500","764773225","194979225","1300975615"
"2023/02/27","160013130","22759460","722128950","185166435","1090067975"
"2023/02/24","266056265","0","252771775","81862445","600690485"
"2023/02/23","294037120","67350","489677090","14419935","798201495"
"2023/02/22","190145370","116900","286977870","13644115","490884255"
"2023/02/21","156062700","1411630","400562160","37621640","595658130"
"2023/02/20","150733745","199659640","476494325","144504005","971391715"
"2023/02/17","113853135","4510","378815660","93079100","585752405"
"2023/02/16","353388165","3301220","619054055","73530960","1049274400"
"2023/02/15","230852635","18036465","503052735","4389345","756331180"
"2023/02/14","292740405","13515","720680740","40639755","1054074415"
"2023/02/13","198417525","27161320","1246716500","50826990","1523122335"
"2023/02/10","137711930","142450","477207195","18700510","633762085"
"2023/02/09","53132445","1749085","447359125","80703655","582944310"
"2023/02/08","139604435","0","367192860","106746525","613543820"
"2023/02/07","241754645","152336250","401163600","11949420","807203915"
"2023/02/06","356862190","623905","637858875","77036840","1072381810"
"2023/02/03","341530425","14659800","756843035","656209500","1769242760"
"2023/02/02","432983785","1026275","539826165","314749750","1288585975"
"2023/02/01","164666985","0","893806170","75254530","1133727685"
"2023/01/31","542892135","13648935","1055874850","151100155","1763516075"
"2023/01/30","311282590","97595715","777089955","216448335","1402416595"
"2023/01/27","426851365","153589580","1474250045","197012980","2251703970"
"2023/01/26","281375560","87563985","1612667545","115614295","2097221385"
"2023/01/25","330993180","504356500","1685972385","139556250","2660878315"
"2023/01/20","372519075","185509290","632404650","140570645","1331003660"
"2023/01/19","414683385","7429210","755729960","141900655","1319743210"
"2023/01/18","529374305","916395","720660110","137871125","1388821935"
"2023/01/17","537914365","913000","594625110","197719615","1331172090"
"2023/01/16","506341965","5531500","1094931240","483143750","2089948455"
"2023/01/13","421560135","888415","677427140","489462600","1589338290"
"2023/01/12","303727655","4415","491027220","371231085","1165990375"
"2023/01/11","394828920","13173820","496996845","160883710","1065883295"
"2023/01/10","260461975","161654675","646380530","324292685","1392789865"
"2023/01/09","299783180","170512165","764049095","224812340","1459156780"
"2023/01/06","402548100","4384380","603377025","328184025","1338493530"
"2023/01/05","183517445","438605","622405230","11903425","818264705"
"2023/01/04","114087655","12790","504081190","50120410","668302045"
"2023/01/03","179858065","342525175","506923600","52094140","1081400980"
"2023/01/02","129430930","139836745","407149500","84365790","760782965"
"2022/12/29","135946620","24605450","670880820","12593270","844026160"
"2022/12/28","378494790","61855315","1813108510","252917455","2506376070"
"2022/12/27","1238056770","175696385","2028812955","74102540","3516668650"
"2022/12/26","1415161500","122887515","1245602945","78266575","2861918535"
"2022/12/23","649840275","8750","496790230","217502755","1364142010"
"2022/12/22","1254881690","4390","445926105","619120905","2319933090"
"2022/12/21","724606155","92974315","822057185","183435540","1823073195"
"2022/12/20","745573085","45884375","1144281535","78098085","2013837080"
"2022/12/19","491624170","19971900","498907030","155502650","1166005750"
"2022/12/16","667039940","39594170","599853060","978632715","2285119885"
"2022/12/15","717155825","128294470","322291745","109438360","1277180400"
"2022/12/14","665560495","31192945","761723685","176829730","1635306855"
"2022/12/13","409625555","17555","547996965","37141650","994781725"
"2022/12/12","304731655","4410","356262185","121470180","782468430"
"2022/12/09","514501765","74715","307548300","91849320","913974100"
"2022/12/08","223338635","9565770","427278265","40116820","700299490"
"2022/12/07","135359525","5463515","493198125","59150740","693171905"
"2022/12/06","537399550","11062500","501566715","135529635","1185558400"
"2022/12/05","221882795","24485240","576636350","8429885","831434270"
"2022/12/02","263712305","12961360","404832505","152480500","833986670"
"2022/12/01","635652920","4990115","702631610","499849050","1843123695"
"2022/11/30","112480855","6348050","431385740","380579335","930793980"
"2022/11/29","102173840","2856995","308666655","34511365","448208855"
"2022/11/28","233700790","279581300","482989605","219757040","1216028735"
"2022/11/25","108416245","39492875","406367975","205098900","759375995"
"2022/11/24","217686370","25771300","522295370","64647615","830400655"
"2022/11/23","105958425","12402000","547198495","88835060","754393980"
"2022/11/22","155438420","62500300","667319540","17927575","903185835"
"2022/11/21","372208360","16700000","710555705","30572735","1130036800"
"2022/11/18","248406250","21993650","694633695","99996740","1065030335"
"2022/11/17","117972605","997575","565298420","140458095","824726695"
"2022/11/16","86960555","184599635","646521245","255121780","1173203215"
"2022/11/15","190577480","2999500","749792150","65067855","1008436985"
"2022/11/14","443033605","4668830","799829410","173517105","1421048950"
"2022/11/11","761318525","116113370","1779556035","262370375","2919358305"
"2022/11/10","91273260","16170780","597992270","182135375","887571685"
"2022/11/09","131103935","52906945","500121345","236503145","920635370"
"2022/11/08","190122415","16484375","1317767320","32743790","1557117900"
"2022/11/07","136931310","42057420","859223515","237473130","1275685375"
"2022/11/04","213851355","18944665","1104589700","86954575","1424340295"
"2022/11/03","135861635","20008075","1307573015","289746710","1753189435"
"2022/11/02","326305360","72928150","1745832950","393433555","2538500015"
"2022/11/01","541986685","42050","1046416600","85183110","1673628445"
"2022/10/31","223469430","7767725","944692675","1239012620","2414942450"
"2022/10/28","273798145","14540380","1193241705","48613355","1530193585"
"2022/10/27","719090070","26178535","1507721450","360775585","2613765640"
"2022/10/26","587023380","16204325","918565530","122618400","1644411635"
"2022/10/25","453685925","0","842241205","89092735","1385019865"
"2022/10/24","436747825","39931595","1408476175","276415195","2161570790"
"2022/10/21","569246765","75203120","2586901470","54883205","3286234560"
"2022/10/20","625326925","85476090","3070350315","143082070","3924235400"
"2022/10/19","474587795","143401760","2846959705","381659605","3846608865"
"2022/10/18","986030745","160589500","2364305925","275238410","3786164580"
"2022/10/17","940991735","147760715","2558594330","305798555","3953145335"
"2022/10/14","453301635","14749370","1208729825","73322785","1750103615"
"2022/10/13","260441845","1588960430","1280049780","812471150","3941923205"
"2022/10/12","197056510","510030840","859121520","13495385","1579704255"
"2022/10/11","291915605","247331850","1125013645","97779895","1762040995"
"2022/10/07","234742400","179047940","383727220","981236505","1778754065"
"2022/10/06","397679770","89633905","799997980","935893630","2223205285"
"2022/10/05","162749000","152980","452208890","833962755","1449073625"
"2022/10/04","325119830","33918410","488291520","944005445","1791335205"
"2022/09/30","282173470","76809600","419831035","2648263775","3427077880"
"2022/09/29","378757155","5358935","902072920","210915890","1497104900"
"2022/09/28","727030570","246067980","2354733055","428485705","3756317310"
"2022/09/27","787021645","447940","687400565","287850605","1762720755"
"2022/09/26","298705365","556057620","906521315","880302580","2641586880"
"2022/09/23","501857500","261041090","2422305815","86469675","3271674080"
"2022/09/22","266073510","96900570","1469870785","3166620","1836011485"
"2022/09/21","426614480","91144875","752789380","422005860","1692554595"
"2022/09/20","588257755","83466680","548115105","319704525","1539544065"
"2022/09/19","700906575","14886485","1379341605","658497260","2753631925"
"2022/09/16","179758025","4855","740739870","25423284320","26343787070"
"2022/09/15","262416485","26402500","1045571945","5029300720","6363691650"
"2022/09/14","902462765","0","1459136840","5704936070","8066535675"
"2022/09/13","1204070935","19960850","1477857540","6104126205","8806015530"
"2022/09/08","1716692810","158675625","3399257570","9633007655","14907633660"
"2022/09/07","574023500","31533820","1060755260","60559670","1726872250"
"2022/09/06","216853865","11366795","433906665","133487715","795615040"
"2022/09/05","258377535","193193365","1091178695","75821095","1618570690"
"2022/09/02","243375715","74418140","1294190600","245792040","1857776495"
"2022/09/01","1128569670","373728595","1042894025","94471845","2639664135"
"2022/08/31","188673020","150555880","638406220","657582790","1635217910"
"2022/08/30","193666025","135448650","1106595470","364700785","1800410930"
"2022/08/29","482587375","60609615","805510405","318359625","1667067020"
"2022/08/26","172954645","25424935","575665560","59520000","833565140"
"2022/08/25","594859085","9290000","685873875","268946425","1558969385"
"2022/08/24","276462410","13964205","1231892105","206776980","1729095700"
"2022/08/23","337408595","62798560","1803895360","111359285","2315461800"
"2022/08/22","262613635","20455460","946553635","59266030","1288888760"
"2022/08/19","149350835","23600000","575364945","165629315","913945095"
"2022/08/18","297303690","59032000","504501030","207640245","1068476965"
"2022/08/17","233129665","25066500","764282215","141429860","1163908240"
"2022/08/16","382802750","29370160","1086457960","102204505","1600835375"
"2022/08/12","203269500","29058560","766970925","112125800","1111424785"
"2022/08/11","341871720","78686655","557896675","422394330","1400849380"
"2022/08/10","213314495","25849685","548127335","208916975","996208490"
"2022/08/09","261130095","15694580","1061956345","131238310","1470019330"
"2022/08/08","741132940","63392220","2046788505","463043615","3314357280"
"2022/08/05","891457330","23340555","1347004305","396920370","2658722560"
"2022/08/04","1080193420","25170645","1320827850","833091465","3259283380"
"2022/08/03","2406339120","56508020","5248719155","1123081680","8834647975"
"2022/08/02","729029595","1503350","583225995","369530620","1683289560"
"2022/08/01","1660917820","118657160","3749928640","786187560","6315691180"
"2022/07/29","799307605","4834075","1295970815","783009295","2883121790"
"2022/07/28","281635020","70179880","659209610","20483645","1031508155"
"2022/07/27","384315905","0","314301910","64521700","763139515"
"2022/07/26","235188030","0","393154785","137540750","765883565"
"2022/07/25","134613410","2254485","637831975","247126505","1021826375"
"2022/07/22","286598045","46178510","974624540","600364210","1907765305"
"2022/07/21","798476560","8599320","1065669885","488960275","2361706040"
"2022/07/20","160639030","251929020","1477465250","955440215","2845473515"
"2022/07/19","249269040","86257265","1412280230","2667024895","4414831430"
"2022/07/18","588794645","138381055","1639208360","895819880","3262203940"
"2022/07/15","767123920","56339865","1518801340","952453360","3294718485"
"2022/07/14","1091016050","6532500","2002234030","1389977930","4489760510"
"2022/07/13","862852425","396043420","2588500800","335657425","4183054070"
"2022/07/12","721047165","342603480","3970403515","787005685","5821059845"
"2022/07/11","655206070","268524815","2891764445","440421715","4255917045"
"2022/07/08","3609831675","261138775","4354620120","1228066045","9453656615"
"2022/07/07","871580755","93850475","3059551920","533729695","4558712845"
"2022/07/06","950650140","116051585","2577329365","340943895","3984974985"
"2022/07/05","1843534200","115531080","1664248655","203730950","3827044885"
"2022/07/04","1617734745","604896285","3836149470","1630164395","7688944895"
"2022/07/01","1767918420","87582630","4924487000","1239804050","8019792100"
"2022/06/30","1013193275","187329710","3871893420","832049280","5904465685"
"2022/06/29","2347345475","184011075","7444121585","276157585","10251635720"
"2022/06/28","3324596510","314527490","4018097780","264861420","7922083200"
"2022/06/27","1221949780","116916210","1255905930","359112330","2953884250"
"2022/06/24","1487315320","141642700","2320104830","281453200","4230516050"
"2022/06/23","2538728110","174478130","1693099400","719370490","5125676130"
"2022/06/22","757502980","314924540","2891373930","1056671350","5020472800"
"2022/06/21","1032659400","80253580","1356252670","229943080","2699108730"
"2022/06/20","816183210","385813500","3307374140","1943900900","6453271750"
"2022/06/17","1859691630","211508060","2373499860","1805334770","6250034320"
"2022/06/16","545823160","31135900","2758288560","276227680","3611475300"
"2022/06/15","638081570","104768110","1463574990","283437760","2489862430"
"2022/06/14","806851310","163245960","2465690620","259814450","3695602340"
"2022/06/13","1654757560","209500300","2165378490","147023320","4176659670"
"2022/06/10","3681335590","5650000","398265140","204809950","4290060680"
"2022/06/09","619623820","6994700","968557740","261143710","1856319970"
"2022/06/08","1308420630","55872850","1328662260","225178950","2918134690"
"2022/06/07","2530771860","1741568700","1478087530","868765670","6619193760"
"2022/06/03","1748859370","94821700","1108189740","445792140","3397662950"
"2022/06/02","1452538690","155440580","983315060","239156830","2830451160"
"2022/05/31","1094760140","462340000","1340139740","1517805080","4415044960"
"2022/05/30","1510788940","241739570","960575280","384928170","3098031960"
"2022/05/27","1711932930","45331800","760287000","550563520","3068115250"
"2022/05/26","1787284940","1389689570","665732590","321774960","4164482060"
"2022/05/25","1016010630","309967330","648857220","179168490","2154003670"
"2022/05/24","1084504820","342085270","766632250","230748290","2423970630"
"2022/05/23","1119716830","383801830","1893606430","1098119940","4495245030"
"2022/05/20","867229700","5560","814930490","367154720","2049320470"
"2022/05/19","1054250770","167789110","2394912550","569573540","4186525970"
"2022/05/18","579151070","7339460","486164640","100491930","1173147100"
"2022/05/17","1283696250","91031210","2481018170","771034280","4626779910"
"2022/05/16","937442550","5690","516321480","310054800","1763824520"
"2022/05/13","658154290","90481950","542028410","273145510","1563810160"
"2022/05/12","753657830","232892000","1552329800","577849830","3116729460"
"2022/05/11","1141567890","11370","888276790","156676220","2186532270"
"2022/05/10","830840120","70458840","1122756640","122157410","2146213010"
"2022/05/09","709167070","28840350","788703910","493153200","2019864530"
"2022/05/06","1033190880","32803310","1983543850","596387450","3645925490"
"2022/05/04","1257738950","154263090","1673277000","203849280","3289128320"
"2022/05/03","1713281160","33557000","4101943410","582304480","6431086050"
"2022/05/02","997667670","5880000","716256590","95678030","1815482290"
"2022/04/29","1781676770","102865000","1195838100","425822780","3506202650"
"2022/04/28","1969619630","29250000","1882750170","585069070","4466688870"
"2022/04/27","1527553510","42259420","1524786220","164570920","3259170070"
"2022/04/26","1606239150","5830000","1494121480","1220647220","4326837850"
"2022/04/25","1774546970","5750000","1831416090","1141207540","4752920600"
"2022/04/22","1032444990","95831720","1755939980","711027690","3595244380"
"2022/04/21","1111940590","43977070","2109225040","410346900","3675489600"
"2022/04/20","1875699910","118768740","1482725990","556137580","4033332220"
"2022/04/19","975825870","1974390","1650408390","8153256630","10781465280"
"2022/04/18","3731531490","178296200","6549760020","750979020","11210566730"
"2022/04/15","2803903750","135360760","3028097880","1053143640","7020506030"
"2022/04/14","2599871060","0","2251973530","2820610860","7672455450"
"2022/04/13","2184280140","10016700","1967436370","1190609990","5352343200"
"2022/04/12","2241836570","115186180","2331540620","1870233580","6558796950"
"2022/04/11","1339129510","271428510","1942275860","1666494020","5219327900"
"2022/04/08","1561366250","19655840","2698413010","1992779870","6272214970"
"2022/04/07","2052343180","38794860","1257374260","681239340","4029751640"
"2022/04/06","1275124160","0","1442490870","1030904480","3748519510"
"2022/04/05","753936940","23721600","1408297350","1229671790","3415627680"
"2022/04/04","406747780","235643320","1826047060","1199757470","3668195630"
"2022/04/01","514471600","119484300","1973829260","746422110","3354207270"
"2022/03/31","1223530970","163241000","2176140460","1277917520","4840829950"
"2022/03/30","391732220","313440500","1377240070","902584930","2984997720"
"2022/03/29","315023890","55449250","904030770","716924460","1991428370"
"2022/03/28","525822480","48195420","1423452360","958872720","2956342980"
"2022/03/25","732632090","54929760","1623643130","984181280","3395386260"
"2022/03/24","1319542540","41609780","880001700","1026516970","3267670990"
"2022/03/23","412206570","243685770","1310680800","1282183250","3248756390"
"2022/03/22","721382060","75090000","1194256490","1412572820","3403301370"
"2022/03/21","1095174040","86351370","1041398460","258969570","2481893440"
"2022/03/18","859954090","4961880","1535913140","298837820","2699666930"
"2022/03/17","847051850","43068640","1151128350","793941530","2835190370"
"2022/03/16","941213540","196945270","898209520","676087070","2712455400"
"2022/03/15","753316790","166749430","839842750","519886350","2279795320"
"2022/03/14","775811630","143567420","805146300","405720290","2130245640"
"2022/03/11","716335560","100488980","1078682170","796776070","2692282780"
"2022/03/10","987650870","262127380","780330540","466751840","2496860630"
"2022/03/08","937639130","133343460","1283947160","525010820","2879940570"
"2022/03/07","503520700","92017570","926814120","1138012470","2660364860"
"2022/03/04","834914920","93031310","1098570850","1464624740","3491141820"
"2022/03/03","982994720","63016990","1269632540","638784930","2954429180"
"2022/03/02","771694930","381365390","580940750","604238570","2338239640"
"2022/02/28","494829680","150770710","1208869450","441840990","2296310830"
"2022/02/25","1143257380","103689920","682001190","1106324060","3035272550"
"2022/02/24","741959550","60926000","1579746770","1137568170","3520200490"
"2022/02/23","505382490","26755360","384423900","900864820","1817426570"
"2022/02/22","437032750","48200000","1118229190","878985270","2482447210"
"2022/02/21","423956310","53848390","499515260","1030588680","2007908640"
"2022/02/18","334827270","210743040","740793330","999616730","2285980370"
"2022/02/17","386464030","53200000","1557061180","1779406870","3776132080"
"2022/02/16","1089864210","52900000","520272390","644227090","2307263690"
"2022/02/15","681302320","68525840","641934290","199547000","1591309450"
"2022/02/14","634759740","26450","610705160","142648670","1388140020"
"2022/02/11","347597570","187832080","814646230","568895550","1918971430"
"2022/02/10","336721390","47701300","744405890","492881730","1621710310"
"2022/02/09","257099200","12748560","968123510","534938960","1772910230"
"2022/02/08","610131100","40181720","917640160","687948350","2255901330"
"2022/02/07","251217300","52905300","1028884440","618638670","1951645710"
"2022/02/04","553789960","9150240","702715110","601799800","1867455110"
"2022/02/03","662192350","26131810","986196860","729584520","2404105540"
"2022/01/28","1252823820","215305070","2263125320","530078730","4261332940"
"2022/01/27","1133017700","206534810","3415115450","334944830","5089612790"
"2022/01/26","605512710","368371660","764756320","315016330","2053657020"
"2022/01/25","759105740","238963600","2658031930","218078340","3874179610"
"2022/01/24","1234043560","187829540","1054337380","173501650","2649712130"
"2022/01/21","461212630","309192330","1061482230","414171700","2246058890"
"2022/01/20","490162040","133287890","968691130","340440500","1932581560"
"2022/01/19","539476820","334092110","2120514990","219765150","3213849070"
"2022/01/18","1073320880","217874600","1347298800","144656180","2783150460"
"2022/01/17","1255705930","853585840","1680394050","236614950","4026300770"
"2022/01/14","786344130","319764850","1112764070","345257690","2564130740"
"2022/01/13","560550630","520273250","776945830","129184210","1986953920"
"2022/01/12","508453270","110889930","523917210","115414710","1258675120"
"2022/01/11","1469495880","860308180","1349309430","170702490","3849815980"
"2022/01/10","1146741530","69110960","571645460","201706970","1989204920"
"2022/01/07","550316250","101426020","541929940","162350800","1356023010"
"2022/01/06","627263700","713229990","1034091590","245355020","2619940300"
"2022/01/05","943686060","159557820","1827725480","143390100","3074359460"
"2022/01/04","907876660","839391340","2063895600","156869580","3968033180"
"2022/01/03","1443312850","240006350","1189083740","296762010","3169164950"
"2021/12/30","1589465220","339122060","2000798020","254723670","4184108970"
"2021/12/29","476930980","465224680","5586746390","525088660","7053990710"
"2021/12/28","2893277450","284274160","2819718270","1003186790","7000456670"
"2021/12/27","11467614560","104739780","2409092060","979743880","14961190280"
"2021/12/24","583101990","580523440","1531282680","896538400","3591446510"
"2021/12/23","997126760","54175550","2025234930","529720220","3606257460"
"2021/12/22","495461090","104662170","1705777100","147449460","2453349820"
"2021/12/21","661248280","26813530","2200472890","10414480","2898949180"
"2021/12/20","637423480","33773360","2163974130","433813180","3268984150"
"2021/12/17","910191590","26905380","1838635340","200919230","2976651540"
"2021/12/16","364173220","10740000","1199762280","23729740","1598405240"
"2021/12/15","939788890","5390760","2136466140","350169000","3431814790"
"2021/12/14","475820670","10776140","1626824430","222491740","2335912980"
"2021/12/13","775372860","0","788740000","239381440","1803494300"
"2021/12/10","996021340","114547020","1133326400","206573370","2450468130"
"2021/12/09","1567216640","24940320","2079558650","274275910","3945991520"
"2021/12/08","959644350","424220210","2099263690","492151610","3975279860"
"2021/12/07","466557180","881209240","1473380660","198199800","3019346880"
"2021/12/06","276015940","152605150","1162094230","158023590","1748738910"
"2021/12/03","829410930","183213550","1408603500","306015930","2727243910"
"2021/12/02","1785974170","203574010","1186303260","444663210","3620514650"
"2021/12/01","709246380","185155400","1581877860","650732810","3127012450"
"2021/11/30","1283359590","461499020","3532440610","795794850","6073094070"
"2021/11/29","769507340","508225300","1738776940","85027460","3101537040"
"2021/11/26","1408301410","443899180","1291764050","598713830","3742678470"
"2021/11/25","263250270","376008200","2097443630","137586710","2874288810"
"2021/11/24","1168748870","34276250","1237220230","140876330","2581121680"
"2021/11/23","284940530","109691950","1511686580","73227990","1979547050"
"2021/11/22","689522750","98136260","1878372160","77574220","2743605390"
"2021/11/19","1241648410","542542470","929693780","189887280","2903771940"
"2021/11/18","544337200","189654420","2788872900","355150880","3878015400"
"2021/11/17","647518450","138596500","3119079360","28414410","3933608720"
"2021/11/16","643303980","340742910","1883710340","89206660","2956963890"
"2021/11/15","661941080","150150780","1139785450","208773840","2160651150"
"2021/11/12","942735760","403000","966080280","92650190","2001869230"
"2021/11/11","1786463580","16310000","948945190","411304940","3163023710"
"2021/11/10","1782272480","7052430","1362971970","599378700","3751675580"
"2021/11/09","927151900","598505430","1667470790","395223180","3588351300"
"2021/11/08","446560790","95907510","1105597840","2837605300","4485671440"
"2021/11/05","1520273500","274298870","1676445170","373198240","3844215780"
"2021/11/04","1318942000","51317060","1457798800","126725780","2954783640"
"2021/11/03","929074040","4289640","1351077200","665125380","2949566260"
"2021/11/02","497139130","51356890","1383661000","394715740","2326872760"
"2021/11/01","1263835710","68590000","2215990240","178836270","3727252220"
"2021/10/29","1143140790","258169050","1700480500","133410640","3235200980"
"2021/10/28","2713175090","152323700","2254978850","942910490","6063388130"
"2021/10/27","1437816320","124015640","1203247020","539388660","3304467640"
"2021/10/26","1532045160","16472550","1590148630","338643590","3477309930"
"2021/10/25","1628339830","351833740","1556942970","302505630","3839622170"
"2021/10/22","1788136130","465269570","1301277680","111328980","3666012360"
"2021/10/21","1111350390","1002914560","923792830","445934500","3483992280"
"2021/10/20","1287079820","6444640","1414902100","378096120","3086522680"
"2021/10/19","1772513350","426381480","1708988600","548005230","4455888660"
"2021/10/18","231986090","27200000","1323026220","208304510","1790516820"
"2021/10/15","1252225810","105371300","1412141370","454269430","3224007910"
"2021/10/14","691811490","0","881488800","308289760","1881590050"
"2021/10/13","999997680","52652710","1571302770","226214010","2850167170"
"2021/10/12","847495740","119883980","2510268070","1118007450","4595655240"
"2021/10/08","966970510","274773300","1006414260","110849010","2359007080"
"2021/10/07","337487870","156215840","849064070","1171142570","2513910350"
"2021/10/06","1634392930","134645190","3167141690","2162582630","7098762440"
"2021/10/05","759698580","115324730","2384503240","908852010","4168378560"
"2021/10/01","1343116560","121322800","2188033660","333416440","3985889460"
"2021/09/30","1817557890","172210360","1940057230","390381890","4320207370"
"2021/09/29","2245259270","179309380","1550213120","499098560","4473880330"
"2021/09/28","1833131590","185341440","3160948320","539430940","5718852290"
"2021/09/27","6397481310","335632490","3437569880","768979630","10939663310"
"2021/09/24","8085330820","98517500","1962423500","364876920","10511148740"
"2021/09/23","3946943160","41861920","2644554510","845082750","7478442340"
"2021/09/17","22975555460","184841700","2064047230","1626587700","26851032090"
"2021/09/16","1818686980","115543790","3686943860","5203326970","10824501600"
"2021/09/15","1133877160","259896500","2339467160","737373600","4470614420"
"2021/09/14","1653199570","12307700","1724748680","765238130","4155494080"
"2021/09/13","1067742040","80168230","2837292130","613116170","4598318570"
"2021/09/10","1024523470","36954060","1361011200","165727870","2588216600"
"2021/09/09","1986890530","4460400","1062598560","261544000","3315493490"
"2021/09/08","1239748960","489200000","602344100","30095560","2361388620"
"2021/09/07","1207459130","492361700","639243040","56592210","2395656080"
"2021/09/06","1027956140","286478400","1274197170","1125720","2589757430"
"2021/09/03","2177682990","370950000","786279570","250600550","3585513110"
"2021/09/02","2321519320","560439770","2596211560","74634250","5552804900"
"2021/09/01","788728150","399397200","2467950710","439238800","4095314860"
"2021/08/31","1833566650","160646400","3318988050","1058764450","6371965550"
"2021/08/30","327223350","0","1260317370","455205060","2042745780"
"2021/08/27","760245690","122044040","1233415560","706053590","2821758880"
"2021/08/26","1271206480","527000","418196330","134583710","1824513520"
"2021/08/25","603533780","531384320","919198690","466189220","2520306010"
"2021/08/24","555567520","477896780","828909760","474877570","2337251630"
"2021/08/23","1179599990","219495730","2457255930","440473720","4296825370"
"2021/08/20","910400140","20282660","1282344800","923300520","3136328120"
"2021/08/19","648482970","106601300","1264563670","618986240","2638634180"
"2021/08/18","806749670","0","503069580","662273610","1972092860"
"2021/08/17","1178095530","3634660","1006409120","339011030","2527150340"
"2021/08/13","801214590","61292750","1902725310","524460060","3289692710"
"2021/08/12","437075900","105600000","747647390","755679260","2046002550"
"2021/08/11","880014280","52810550","683385320","512311820","2128521970"
"2021/08/10","473981510","0","391825690","600840970","1466648170"
"2021/08/09","1054392190","280587330","1703043010","5298292150","8336314680"
"2021/08/06","1469051010","130781410","1116767010","354644570","3071244000"
"2021/08/05","495757080","257469100","1936525550","1681225590","4370977320"
"2021/08/04","1576936070","33681120","876979220","324028090","2811624500"
"2021/08/03","2114438010","82682520","1363641600","684678330","4245440460"
"2021/08/02","1126101400","88768500","731352240","61960680","2008182820"
"2021/07/30","1071187710","315248000","708198860","167552370","2262186940"
"2021/07/29","339782060","213802000","841021670","256826210","1651431940"
"2021/07/28","927362000","495823300","2965668830","343369720","4732223850"
"2021/07/27","516395390","26450000","893350360","56269360","1492465110"
"2021/07/26","990272040","26700000","2381867280","685937720","4084777040"
"2021/07/23","661489730","108515940","1593459710","156543370","2520008750"
"2021/07/22","727732920","313640800","1412002920","222526340","2675902980"
"2021/07/21","547554480","216470000","790823610","5300034300","6854882390"
"2021/07/20","529932980","9687640","1386472130","299708780","2225801530"
"2021/07/19","529897550","6015300","836786280","381125580","1753824710"
"2021/07/16","331429300","263500","1199402100","417557200","1948652100"
"2021/07/15","970624670","157831900","981915370","159845010","2270216950"
"2021/07/14","1335357750","117020860","1354633380","172184980","2979196970"
"2021/07/13","603731250","38719320","872876580","160165380","1675492530"
"2021/07/12","630675020","76721300","1230499670","276180940","2214076930"
"2021/07/09","388481930","30685540","849820090","714158230","1983145790"
"2021/07/08","548933950","152304820","1091687450","462984410","2255910630"
"2021/07/07","349942360","79050000","847022550","464409060","1740423970"
"2021/07/06","356941060","76605270","1926019780","771580040","3131146150"
"2021/07/05","465633300","390859300","3921033080","3344649020","8122174700"
"2021/07/02","387572760","111552000","2421593430","1965880840","4886599030"
"2021/07/01","1583347020","10851810","1943222080","485153110","4022574020"
"2021/06/30","610595070","266345440","2250434960","315062520","3442437990"
"2021/06/29","1495449980","279315960","7227179690","469263080","9471208710"
"2021/06/28","2980102810","318227790","4939922140","3277846920","11516099660"
"2021/06/25","1896641930","477620540","2032658310","221385280","4628306060"
"2021/06/24","1115004840","74719400","1429508490","153188930","2772421660"
"2021/06/23","1716446040","231773370","3057225120","34864000","5040308530"
"2021/06/22","844766050","531430310","2226334120","32050640","3634581120"
"2021/06/21","1273920210","159485000","2609268270","154756210","4197429690"
"2021/06/18","11168357620","239270000","2553697980","1092305870","15053631470"
"2021/06/17","1447151150","127607480","2475328180","849008330","4899095140"
"2021/06/16","7438569570","375385930","4553945710","170266120","12538167330"
"2021/06/15","1691313400","362607030","3105607800","39848820","5199377050"
"2021/06/14","9852324390","342752300","1168109290","62457640","11425643620"
"2021/06/11","1522165270","359598840","1635367410","222435550","3739567070"
"2021/06/10","20874581950","55576510","440600910","19352610","21390111980"
"2021/06/09","2966515020","1086326720","2259782510","123490720","6436114970"
"2021/06/08","390647370","621815500","1519473530","54739270","2586675670"
"2021/06/07","1397574260","284702000","1605304220","1291730","3288872210"
"2021/06/04","571048210","119829900","1634614480","27891110","2353383700"
"2021/06/03","1828481780","1132568070","5733400440","143888550","8838338840"
"2021/06/02","29847143810","814337960","2755060250","1364969280","34781511300"
"2021/06/01","8256878290","130406110","1854729330","825370870","11067384600"
"2021/05/31","1208624990","78330400","2017478070","584036480","3888469940"
"2021/05/28","1041897940","52100000","1158122100","58958220","2311078260"
"2021/05/27","2756079590","56945400","737728360","313325580","3864078930"
"2021/05/26","601826180","110281850","428533460","2016080","1142657570"
"2021/05/25","1608168360","66796910","495321700","374415300","2544702270"
"2021/05/24","1989420900","0","829577640","24973170","2843971710"
"2021/05/21","801126950","15450000","629277290","60516480","1506370720"
"2021/05/20","1088294370","155950400","669514640","54744330","1968503740"
"2021/05/18","686815080","81174920","1216678210","66295290","2050963500"
"2021/05/17","385672970","105740320","720516360","43901280","1255830930"
"2021/05/14","890102310","264284950","906735290","50820710","2111943260"
"2021/05/13","935071990","572033440","1668828030","21808310","3197741770"
"2021/05/12","1102742740","54526040","638415660","133832910","1929517350"
"2021/05/11","467163790","235291320","858640140","125782720","1686877970"
"2021/05/10","706384350","903204940","1546001940","106668530","3262259760"
"2021/05/07","509016280","760496820","3048535660","64310660","4382359420"
"2021/05/06","363265030","708056930","1821132760","232932480","3125387200"
"2021/05/04","643327610","287825700","2202863500","266344070","3400360880"
"2021/05/03","466886040","128083200","2570269700","79675360","3244914300"
"2021/04/30","1136483700","260763910","1975930800","154891490","3528069900"
"2021/04/29","48175371950","115612000","1168907480","3852070400","53311961830"
"2021/04/28","1297609090","477501090","3715191300","51225530","5541527010"
"2021/04/27","380559960","157307280","1225852040","999443760","2763163040"
"2021/04/26","715921410","77964660","2571502420","3614010","3369002500"
"2021/04/23","364180960","26143460","1378667700","149345060","1918337180"
"2021/04/22","697074720","34941550","1647387260","31318230","2410721760"
"2021/04/21","196761370","113442000","769585740","4909620","1084698730"
"2021/04/20","399983950","295509000","1508519810","89779360","2293792120"
"2021/04/19","402830010","35849470","2164303560","333022560","2936005600"
"2021/04/16","428407060","130437400","2492236200","519283010","3570363670"
"2021/04/15","26281523670","675408400","764704300","406729590","28128365960"
"2021/04/14","457609750","166170000","986298850","45006400","1655085000"
"2021/04/13","36324293230","40181690","640663620","8761010","37013899550"
"2021/04/12","608158350","31667190","1114754330","65957720","1820537590"
"2021/04/09","824005960","159886490","685490380","25512969350","27182352180"
"2021/04/08","276319380","30347200","1346392650","122621190","1775680420"
"2021/04/07","369837460","31420260","400764710","61544350","863566780"
"2021/04/06","81627030","114732210","659066310","66777390","922202940"
"2021/04/05","265117200","338084220","1119719790","150447460","1873368670"
"2021/04/02","221405120","59886850","707248870","474566170","1463107010"
"2021/04/01","257915560","113763150","518365800","246495860","1136540370"
"2021/03/31","509619100","71974340","1079696600","141826720","1803116760"
"2021/03/30","5440863700","63315620","399678120","130744110","6034601550"
"2021/03/29","25061543130","75883000","1160373080","259065700","26556864910"
"2021/03/26","23019724570","85795700","673449600","467324350","24246294220"
"2021/03/25","223343140","101795040","418299510","153730040","897167730"
"2021/03/24","338346410","15690000","372146220","190884080","917066710"
"2021/03/23","500832320","93960000","518920300","534620480","1648333100"
"2021/03/22","92945150","56382000","483378910","72690010","705396070"
"2021/03/19","434539430","217965100","873636670","30751510","1556892710"
"2021/03/18","120771600","164058570","370559440","51736330","707125940"
"2021/03/17","112542950","20720000","219487670","71775150","424525770"
"2021/03/16","227024190","1551000","156526610","136559750","521661550"
"2021/03/15","287095440","213758760","418345700","141472190","1060672090"
"2021/03/12","298946400","1994300","591270970","52213430","944425100"
"2021/03/11","266781140","0","449439930","48126870","764347940"
"2021/03/10","392400100","0","525023480","19392520","936816100"
"2021/03/09","123538120","0","392531580","125926220","641995920"
"2021/03/08","174047530","5993850","388104670","14798630","582944680"
"2021/03/05","94501240","9947080","476804550","22458050","603710920"
"2021/03/04","80944420","0","213048240","9359300","303351960"
"2021/03/03","115463080","0","372834020","238749460","727046560"
"2021/03/02","110470000","0","525819600","161761270","798050870"
"2021/02/26","542606090","46470350","318523740","124651630","1032251810"
"2021/02/25","384481920","17505680","390621800","286568920","1079178320"
"2021/02/24","496369700","0","436947760","388259930","1321577390"
"2021/02/23","736744140","1036000","186355720","13982880","938118740"
"2021/02/22","381466620","103604700","953622960","30353560","1469047840"
"2021/02/19","213714590","51800000","959877320","113182000","1338573910"
"2021/02/18","225445150","0","359485210","39612250","624542610"
"2021/02/17","140481050","78951350","573337330","110838990","903608720"
"2021/02/16","321370420","0","298204540","31957630","651532590"
"2021/02/15","299177130","496320","254551020","111731690","665956160"
"2021/02/10","143252070","0","344993770","64508860","552754700"
"2021/02/09","412100790","0","263332880","0","675433670"
"2021/02/08","933839980","15330000","489302820","262239880","1700712680"
"2021/02/05","443938080","1521000","349075070","37505640","832039790"
"2021/02/04","406621020","14696840","438529910","37397530","897245300"
"2021/02/03","285162180","15240000","193471030","287268440","781141650"
"2021/02/02","150873110","1018000","303545800","55872920","511309830"
"2021/02/01","270398450",,"120884980","11698840","402982270"
"2021/01/29","321393810","15768820","354577150","29636660","721376440"
"2021/01/28","305334120","997640","279766780","27845420","613943960"
"2021/01/27","328521900","3066000","148915950","82866480","563370330"
"2021/01/26","498337210","25600000","474028200","27085250","1025050660"
"2021/01/25","66305590","509000","280503850","92732270","440050710"
"2021/01/22","267989420","47295000","543254270","31762940","890301630"
"2021/01/21","158753560","197284060","211375600","50171220","617584440"
"2021/01/20","648630220","154500000","208692910","84678040","1096501170"
"2021/01/19","809467110","0","402239940","15486280","1227193330"
"2021/01/18","1395164440","75392560","203231790","213480230","1887269020"
"2021/01/15","374396510","8589940","471966170","420002890","1274955510"
"2021/01/14","123010810","1015060","252531170","227115480","603672520"
"2021/01/13","351671350","12575000","305484860","290253470","959984680"
"2021/01/12","472462650","37374870","475759395","234864910","1220461825"
"2021/01/11","582920180","40856750","1996127070","419270380","3039174380"
"2021/01/08","526643900","44774000","1921858720","53157230","2546433850"
"2021/01/07","590368700","63710980","1610904500","19391400","2284375580"
"2021/01/06","510399660","85955100","617294050","510000","1214158810"
"2021/01/05","441060760","5100000","564100390","843199180","1853460330"
"2021/01/04","216798030","36801220","625145760","1325300500","2204045510"
"2020/12/30","418603480","2545000","1095277350","168098720","1684524550"
"2020/12/29","332671910","10240000","1925479490","851832750","3120224150"
"2020/12/28","2807460960","97991800","1766915130","185587500","4857955390"
"2020/12/24","219525680","2640000","1035190260","131024540","1388380480"
"2020/12/23","5232426930","65381910","642698540","300138590","6240645970"
"2020/12/22","470139840","61060000","669812430","349148790","1550161060"
"2020/12/21","164398580","59515900","762970280","634232720","1621117480"
"2020/12/18","89844050","32572710","1238311910","16322997460","17683726130"
"2020/12/17","116826150","0","1744541790","2156066630","4017434570"
"2020/12/16","885052150","0","1237402190","1561397960","3683852300"
"2020/12/15","681053540","31075100","785044630","2160468550","3657641820"
"2020/12/14","65204880","8764350","696644200","945447880","1716061310"
"2020/12/11","411463880","10220000","1228369020","699879020","2349931920"
"2020/12/10","336736290","3060000","531770180","636232960","1507799430"
"2020/12/09","121918220","0","631579250","489033500","1242530970"
"2020/12/08","312345540","4590000","438165200","278454760","1033555500"
"2020/12/07","584626100","4109720","588021280","660330690","1837087790"
"2020/12/04","476818090","0","1799275880","123857040","2399951010"
"2020/12/03","159499050",,"528135020","84962980","772597050"
"2020/12/02","89804150","0","576428440","43506420","709739010"
"2020/12/01","637211750","15094830","1453813110","72569740","2178689430"
"2020/11/30","477058060","33153100","1122247040","1216848240","2849306440"
"2020/11/27","388439790","8319040","265561560","637849550","1300169940"
"2020/11/26","224123120","8218260","286723960","609252510","1128317850"
"2020/11/25","414217050","78211000","1051520820","587611780","2131560650"
"2020/11/24","296757910","104000820","572953390","558378170","1532090290"
"2020/11/23","482518530","847600","565479690","1238279490","2287125310"
"2020/11/20","131219950","5150000","235991870","167995420","540357240"
"2020/11/19","682043150","6213760","265570640","333309040","1287136590"
"2020/11/18","421284650","30330000","236050200","389620750","1077285600"
"2020/11/17","364644430","0","1498263310","125869460","1988777200"
"2020/11/16","457276550","10220000","1340066000","331606010","2139168560"
"2020/11/13","564109930","43285000","1341257720","280598090","2229250740"
"2020/11/12","246600470","2555000","881982960","122321430","1253459860"
"2020/11/11","110314370",,"238704880","814906850","1163926100"
"2020/11/10","397737420","36008080","707571400","109122800","1250439700"
"2020/11/09","300187000","0","1710563190","55990800","2066740990"
"2020/11/06","285576690",,"676276930","162628430","1124482050"
"2020/11/05","347131310","0","550027990","130253030","1027412330"
"2020/11/04","97577040","68170000","394429700","88011080","648187820"
"2020/11/03","137025470","0","713334500","67869670","918229640"
"2020/11/02","364558760","0","786447450","117811750","1268817960"
"2020/10/30","527723930","0","880011410","148609210","1556344550"
"2020/10/29","103387050","997020","434283280","21427090","560094440"
"2020/10/28","79491720","0","456515780","84514660","620522160"
"2020/10/27","227115510","52314000","915348490","478917230","1673695230"
"2020/10/26","335253140","145272500","788320690","132420810","1401267140"
"2020/10/23","144956420","218280000","473687280","171908720","1008832420"
"2020/10/22","302494410","925682470","313670160","331308340","1873155380"
"2020/10/21","278729910","53329370","374246110","90142390","796447780"
"2020/10/20","195866960","6275970","375606150","29992280","607741360"
"2020/10/19","105151150","8310880","620674880","90925840","825062750"
"2020/10/16","343190220","0","1361472280","204518450","1909180950"
"2020/10/15","209856970",,"602563580","47492500","859913050"
"2020/10/14","126716170","445440","906767030","302670","1034231310"
"2020/10/13","153686770","111980","1268675410","393579410","1816053570"
"2020/10/12","179953520","0","859319170","225577410","1264850100"
"2020/10/08","145173845","11053190","1372169475","161079440","1689475950"
"2020/10/07","167312940","2497500","486924490","38300020","695034950"
"2020/10/06","412747260","30060000","916277025","224635310","1583719595"
"2020/10/05","341083030","996000","582361005","17073425","941513460"
"2020/09/29","292694880","0","220503690","53040780","566239350"
"2020/09/28","107909985","0","178086970","2581745","288578700"
"2020/09/25","269735625","0","517876405","2322590","789934620"
"2020/09/24","158123090","0","187501650","127247500","472872240"
"2020/09/23","1133591000","4870000","737992290","324991425","2201444715"
"2020/09/22","567406520","0","220066555","33395720","820868795"
"2020/09/21","92576600","194300","807492955","32978760","933242615"
"2020/09/18","239029570","14595000","337339690","4870","590969130"
"2020/09/17","289769125","17926795","972326550","9636970","1289659440"
"2020/09/16","250546195","9720000","508929340","96136080","865331615"
"2020/09/15","90623765","12147500","419150540","6218015","528139820"
"2020/09/14","905470690","25571425","688494545","65378800","1684915460"
"2020/09/11","89696005","4855000","884574830","47343055","1026468890"
"2020/09/10","477591410","511875","373600770","4890","851708945"
"2020/09/09","252890825","0","533042400","38522245","824455470"
"2020/09/08","204375785","9397940","2132855745","48727075","2395356545"
"2020/09/07","86455960","7935270","1351620800","45677365","1491689395"
"2020/09/04","187518640","998580","579431255","80918245","848866720"
"2020/09/03","519977710","158956360","497762650","0","1176696720"
"2020/09/02","158310135","34339825","762075245","0","954725205"
"2020/09/01","156379295","0","294648225","0","451027520"
"2020/08/31","128930565","91418405","688237215","43898225","952484410"
"2020/08/28","150808975","176188130","1151635330","8541050","1487173485"
"2020/08/27","94229065","17223970","844861140","46019855","1002334030"
"2020/08/26","167218305","298285555","945481680","22871205","1433856745"
"2020/08/25","284218145","303719520","936585460","1267210","1525790335"
"2020/08/24","256087120","378806965","1585828530","6403600","2227126215"
"2020/08/21","516888425","150761125","991993490","44958970","1704602010"
"2020/08/20","607448180","494656210","2187136825","43818405","3333059620"
"2020/08/19","930158935","278410055","1255255645","101027870","2564852505"
"2020/08/18","1080707550","341372500","1443978020","58407305","2924465375"
"2020/08/14","646412420","239539760","1440985605","89669735","2416607520"
"2020/08/13","3345815480","260659865","1507378135","996000","5114849480"
"2020/08/12","907591955","633368700","3268480400","140354495","4949795550"
"2020/08/11","575031130","124321695","3088673640","179889805","3967916270"
"2020/08/10","1103346350","155612575","3839645245","24303920","5122908090"
"2020/08/07","3324045465","1290773760","18076282605","297109310","22988211140"