일자,기관 합계,기타법인,개인,외국인 합계,전체
"2023/05/04","138659925","32725450","273741600","66141435","511268410"
"2023/05/03","77479820","9583500","66201885","3290340","156555545"
"2023/05/02","36392600","11020960","69239255","12064465","128717280"
"2023/04/28","49023185","23103000","119506730","5690020","197322935"
"2023/04/27","51988955","14705105","82661460","0","149355520"
"2023/04/26","38446810","15398320","110832455","6579420","171257005"
"2023/04/25","26754705","37908375","132000550","4513285","201176915"
"2023/04/24","64112505","38209470","205009400","78249515","385580890"
"2023/04/21","104440730","1638145","235812840","96956905","438848620"
"2023/04/20","60848975","1798960","103627755","28869895","195145585"
"2023/04/19","168659525","21186400","393460795","177570070","760876790"
"2023/04/18","112779865","11004610","209166090","74104475","407055040"
"2023/04/17","167252805","12313715","155273960","46534900","381375380"
"2023/04/14","96732600","10145710","302462225","192088395","601428930"
"2023/04/13","233289540","2211670","165909880","149051930","550463020"
"2023/04/12","247931950","36660010","210346090","300976410","795914460"
"2023/04/11","77591585","43023250","290558775","163483350","574656960"
"2023/04/10","151065950","1620425","426314050","97807655","676808080"
"2023/04/07","76704985","22471560","486942725","78152930","664272200"
"2023/04/06","168787915","3777785","332273900","117112260","621951860"
"2023/04/05","236108410","19323695","362396815","122579570","740408490"
"2023/04/04","32203700","4024680","45999435","679315","82907130"
"2023/04/03","38618685","2537350","92752205","32150960","166059200"
"2023/03/31","54789555","0","114665050","61189450","230644055"
"2023/03/30","49014030","261600","77227395","61146135","187649160"
"2023/03/29","89368085","0","148962410","7848615","246179110"
"2023/03/28","155181295","725370","141804905","166307725","464019295"
"2023/03/27","52066400","1805315","416218285","12175655","482265655"
"2023/03/24","52983495","0","123554885","807975","177346355"
"2023/03/23","64398970","427000","111745815","4280","176576065"
"2023/03/22","22409800","172300","60481640","499380","83563120"
"2023/03/21","34327540","572155","43060495","10711480","88671670"
"2023/03/20","45804760","7034900","59307005","3513280","115659945"
"2023/03/17","20290485","0","50013915","16671190","86975590"
"2023/03/16","79790745","2569000","91805810","11184300","185349855"
"2023/03/15","96326960","1182920","495426865","28378985","621315730"
"2023/03/14","78275210","26680000","110348890","305775","215609875"
"2023/03/13","82901230","0","46023790","231655","129156675"
"2023/03/10","66526200","0","15951505","3648840","86126545"
"2023/03/09","51230385","4475","23622870","30184540","105042270"
"2023/03/08","55009645","1116150","66778795","271225","123175815"
"2023/03/07","57605700","0","33727160","7238240","98571100"
"2023/03/06","69291930","8330750","100951965","262250","178836895"
"2023/03/03","65937845","9817020","132210165","205610","208170640"
"2023/03/02","71456825","9769860","71396215","13672355","166295255"
"2023/02/28","79496660","113625","45046700","553355","125210340"
"2023/02/27","43609335","738875","123944565","8133070","176425845"
"2023/02/24","59648765","0","82357175","10197165","152203105"
"2023/02/23","30228520","9283650","47845690","1160780","88518640"
"2023/02/22","10633595","9275390","62699840","777000","83385825"
"2023/02/21","18483180","0","63725440","8671015","90879635"
"2023/02/20","4971915","4567430","62930740","12792670","85262755"
"2023/02/17","13600775",,"46118175","2010585","61729535"
"2023/02/16","11728755","0","46742570","7685235","66156560"
"2023/02/15","25819785","0","133864655","687405","160371845"
"2023/02/14","38422405","1691555","109089180","10663435","159866575"
"2023/02/13","83884500","8850900","44657725","1305785","138698910"
"2023/02/10","74717790","1774270","107927550","1384600","185804210"
"2023/02/09","29911970","310845","66516855","3954875","100694545"
"2023/02/08","122316205","8285110","216208845","34702460","381512620"
"2023/02/07","152252530","1679500","59820345","15678390","229430765"
"2023/02/06","40269245","225225","87157960","8687755","136340185"
"2023/02/03","519231470","510645","78121665","10928120","608791900"
"2023/02/02","128802915","0","75961785","61952630","266717330"
"2023/02/01","76213895","914255","182527370","21288390","280943910"
"2023/01/31","167555375","1123225","96798940","34638280","300115820"
"2023/01/30","110171475","1905485","147061960","27291190","286430110"
"2023/01/27","150732015","1385690","54049970","593005","206760680"
"2023/01/26","121745230","1004400","68875130","7070570","198695330"
"2023/01/25","165218555","744180","101772445","5860700","273595880"
"2023/01/20","126941770","13115410","48199645","14276570","202533395"
"2023/01/19","75198030","905550","177605045","13554840","267263465"
"2023/01/18","82093650","5376825","70204530","7304235","164979240"
"2023/01/17","67284970","10411500","64943000","8077350","150716820"
"2023/01/16","185173035","996450","40835495","6244990","233249970"
"2023/01/13","134087630","10367570","41517675","23999330","209972205"
"2023/01/12","118574785","0","15642145","252680","134469610"
"2023/01/11","124285720",,"24038615","2173125","150497460"
"2023/01/10","73175005",,"40696085","9318780","123189870"
"2023/01/09","92947475",,"62583795","83070","155614340"
"2023/01/06","225888665","0","34419255","29720975","290028895"
"2023/01/05","264680135","224500","48824650","50685660","364414945"
"2023/01/04","86767925","5002500","37530885","33577215","162878525"
"2023/01/03","63965535","4996770","25984830","7455685","102402820"
"2023/01/02","47827540","0","108556930","5156250","161540720"
"2022/12/29","38346035","0","52563700","1114725","92024460"
"2022/12/28","45092175","0","28565095","1155600","74812870"
"2022/12/27","59685955","0","54873325","34720","114594000"
"2022/12/26","46676460","0","67670415","1994155","116341030"
"2022/12/23","55231320","0","57802700","4340","113038360"
"2022/12/22","34040415","883550","29883680","1825320","66632965"
"2022/12/21","59270795","329840","7665730","11050925","78317290"
"2022/12/20","120142730","243260","92844490","41085905","254316385"
"2022/12/19","74359915","305300","67524060","8626170","150815445"
"2022/12/16","81411790","2152500","112643240","22254050","218461580"
"2022/12/15","110059610","4358690","131886475","12649120","258953895"
"2022/12/14","132628070","302910","60597440","9757980","203286400"
"2022/12/13","66596495","13075","44967720","929935","112507225"
"2022/12/12","40590130","999585","88248570","2013975","131852260"
"2022/12/09","18225525","26320","162815830","461655","181529330"
"2022/12/08","66613690","884500","47569680","481495","115549365"
"2022/12/07","31588145","2217500","106310005","204010","140319660"
"2022/12/06","39200950","4480","103529880","1827690","144563000"
"2022/12/05","14896160","5766510","98009810","6226145","124898625"
"2022/12/02","57552190","8557790","132623215","9292195","208025390"
"2022/12/01","55670255","5806870","228267315","11907390","301651830"
"2022/11/30","58435750","4876670","109847590","42159925","215319935"
"2022/11/29","32423420","5597225","37755610","22965","75799220"
"2022/11/28","143730145","1922115","31744725","3101005","180497990"
"2022/11/25","138633905","987350","43024980","21987435","204633670"
"2022/11/24","108035020","994400","13492920","8932465","131454805"
"2022/11/23","49764975","22650","26627000","4505","76419130"
"2022/11/22","45674470","0","23069765","1694525","70438760"
"2022/11/21","54545420","20655955","27625440","1874405","104701220"
"2022/11/18","74763355","14479320","42875160","1067685","133185520"
"2022/11/17","10545220","45391670","50682440","2997200","109616530"
"2022/11/16","56422150","21552125","43654985","8532285","130161545"
"2022/11/15","38904535","38862680","70972425","1696535","150436175"
"2022/11/14","42706940","5144500","77414410","11373410","136639260"
"2022/11/11","604744730","20393390","218154370","352246850","1195539340"
"2022/11/10","37761580","5829745","106744390","31460470","181796185"
"2022/11/09","61977585","2612845","47249380","25015600","136855410"
"2022/11/08","26200425","94659270","183151110","16973975","320984780"
"2022/11/07","38228170","40032295","287421095","78800685","444482245"
"2022/11/04","22199375",,"23745740","278015","46223130"
"2022/11/03","5298070","298205","31013595","32760","36642630"
"2022/11/02","33975200","1643000","76313990","293515","112225705"
"2022/11/01","41472250","4105","92451395","7857800","141785550"
"2022/10/31","42883780","6946800","73358995","7506090","130695665"
"2022/10/28","22138720","298080","85012150","6203645","113652595"
"2022/10/27","26535505",,"102143510","28936975","157615990"
"2022/10/26","27003010","3995745","41783650","5799240","78581645"
"2022/10/25","94586470","301460","80040200","11892115","186820245"
"2022/10/24","114954960","5038435","44112785","2260130","166366310"
"2022/10/21","180635185","0","94396345","34520910","309552440"
"2022/10/20","177252390","25262420","94418920","8590470","305524200"
"2022/10/19","236249450","16026000","82575970","101054280","435905700"
"2022/10/18","505206195","8214060","209684595","143512530","866617380"
"2022/10/17","190649095","0","173019995","71321100","434990190"
"2022/10/14","126306755","8904085","227157600","63801290","426169730"
"2022/10/13","114808470","15903900","405292575","45001290","581006235"
"2022/10/12","87030255","7512155","300732900","83402190","478677500"
"2022/10/11","37962070","58584695","75184335","18864460","190595560"
"2022/10/07","53282960","3493120","197279725","18833580","272889385"
"2022/10/06","49276210","11605880","185913265","14694760","261490115"
"2022/10/05","62626680","3288045","153062730","28163785","247141240"
"2022/10/04","47308820","4405","284019615","6786825","338119665"
"2022/09/30","102282030","6730000","289077630","117390","398207050"
"2022/09/29","63198430","11340750","168205005","24931395","267675580"
"2022/09/28","422287370","120282950","1048749440","121948655","1713268415"
"2022/09/27","22901480","18527730","233331750","10387950","285148910"
"2022/09/26","39118600","52707060","191488785","6112680","289427125"
"2022/09/23","20991435","101766500","265698625","3658725","392115285"
"2022/09/22","8031850","1007000","104577380","1070490","114686720"
"2022/09/21","51216310","3847500","112736850","349040","168149700"
"2022/09/20","58208350","16460660","128498490","15450","203182950"
"2022/09/19","304223170","18165200","93389310","19218240","434995920"
"2022/09/16","48718070","3457290","195688170","18087290","265950820"
"2022/09/15","36322440","0","28422040","696810","65441290"
"2022/09/14","67988740","517000","51538100","16973720","137017560"
"2022/09/13","34684070","521000","52237960","5422000","92865030"
"2022/09/08","31817260","0","60592960","12158480","104568700"
"2022/09/07","35681790","8007200","73380160","3223570","120292720"
"2022/09/06","16769350","0","36576950","106000","53452300"
"2022/09/05","18549970","10602500","111915770","1421850","142490090"
"2022/09/02","9746180","0","63253550","281950","73281680"
"2022/09/01","22774560","21515000","79124090","998310","124411960"
"2022/08/31","5188580","5380000","75964970","1007760","87541310"
"2022/08/30","58622070","0","40327740","2989870","101939680"
"2022/08/29","57878780","47878000","128190530","4121200","238068510"
"2022/08/26","165006230","27250000","177960740","8700850","378917820"
"2022/08/25","67463000","32760000","94847080","391680","195461760"
"2022/08/24","46508460","0","53345010","1719900","101573370"
"2022/08/23","35083270","0","95373050","38220","130494540"
"2022/08/22","128466360","543000","46282140","1684050","176975550"
"2022/08/19","96949760","0","138444630","142220","235536610"
"2022/08/18","55071390","1093000","68541870","0","124706260"
"2022/08/17","62798480","5500","43239710","247350","106291040"
"2022/08/16","115592080",,"102696270","80947500","299235850"
"2022/08/12","59148680","997150","127145000","2423080","189713910"
"2022/08/11","187419770","0","92115000","56990710","336525480"
"2022/08/10","23328630","531000","47708330","6707320","78275280"
"2022/08/09","13453460","1529710","53853090","117260","68953520"
"2022/08/08","7301230","0","62128170","212400","69641800"
"2022/08/05","49715890",,"128424130","4749760","182889780"
"2022/08/04","48086010","7354400","107435480","53000","162928890"
"2022/08/03","75420130","0","146350930","16858330","238629390"
"2022/08/02","88953230",,"223108440","3084180","315145850"
"2022/08/01","139947890","23895000","97501290","102116150","363460330"
"2022/07/29","69046320","0","69454200","28081630","166582150"
"2022/07/28","35451240","1036000","169306080","2773440","208566760"
"2022/07/27","43118250","0","79574120","7872460","130564830"
"2022/07/26","22927550","998400","34926440","5160","58857550"
"2022/07/25","50539830","41280","66916490","52000","117549600"
"2022/07/22","78714310","1560000","44376660","2816720","127467690"
"2022/07/21","262782450","0","64290210","0","327072660"
"2022/07/20","132836190","997160","181712160","5424990","320970500"
"2022/07/19","106353550","5908700","38669340","5842210","156773800"
"2022/07/18","112480230","0","60891790","32437360","205809380"
"2022/07/15","87418620","22710510","59873270","104144830","274147230"
"2022/07/14","46442870","23900700","87881480","1434950","159660000"
"2022/07/13","55541030","512000","143356560","1928350","201337940"
"2022/07/12","28893060","16288000","164309630","8035240","217525930"
"2022/07/11","77970880","8141350","144884190","4096810","235093230"
"2022/07/08","51599820","537500","131763260","9705680","193606260"
"2022/07/07","200832110",,"128424300","49528990","378785400"
"2022/07/06","149768730","0","36117940","4081350","189968020"
"2022/07/05","173274070","15625500","71105360","76649440","336654370"
"2022/07/04","211787930","1073000","237726370","42731550","493318850"
"2022/07/01","283681850","177324280","599186500","188607500","1248800130"
"2022/06/30","109429390","18614700","109375990","1403360","238823440"
"2022/06/29","67071620","57686390","60523090","4502730","189783830"
"2022/06/28","457780100","138786310","319745020","75834760","992146190"
"2022/06/27","264786370","370614750","228927490","87540560","951869170"
"2022/06/24","286121880","163034700","106076120","28358260","583590960"
"2022/06/23","182693340","96859180","210862010","192663950","683078480"
"2022/06/22","153101360","185120310","402810950","73012150","814044770"
"2022/06/21","96207080","137007910","194530720","88702000","516447710"
"2022/06/20","568488740","65990940","555976890","159762850","1350219420"
"2022/06/17","205816520","123191720","147593220","12798090","489399550"
"2022/06/16","47943100","151725000","275048350","23163600","497880050"
"2022/06/15","223944890","137748400","205641310","68116920","635451520"
"2022/06/14","180977480","257738110","286312140","62657080","787684810"
"2022/06/13","315639260","213024520","539216890","61337010","1129217680"
"2022/06/10","119579840","86198200","379848260","1208640","586834940"
"2022/06/09","6175120","55710000","63803720","0","125688840"
"2022/06/08","103854030","94071700","46933050","1816600","246675380"
"2022/06/07","24709200","125117340","197345000","62200","347233740"
"2022/06/03","172786280","74548750","127190920","130060","374656010"
"2022/06/02","183606960","0","183194660","492000","367293620"
"2022/05/31","127684400","0","235760710","52067250","415512360"
"2022/05/30","213554750","20629620","321951230","22457930","578593530"
"2022/05/27","710053220","0","245343470","24155800","979552490"
"2022/05/26","404099780","0","309733770","5888100","719721650"
"2022/05/25","460261240","36462760","243911500","265531320","1006166820"
"2022/05/24","200630800","0","110695720","60952160","372278680"
"2022/05/23","149957100","0","138818550","1118500","289894150"
"2022/05/20","151244680","79981600","171156380","855830","403238490"
"2022/05/19","44831130","12210000","116414470","1028180","174483780"
"2022/05/18","230972040","9224400","434973970","10263520","685433930"
"2022/05/17","517538320","14431940","298151680","28682960","858804900"
"2022/05/16","195218050","10043140","154396230","867600","360525020"
"2022/05/13","267348730","6085000","168611510","41478060","483523300"
"2022/05/12","358621020","0","331363390","138657990","828642400"
"2022/05/11","184134070","124300","125461000","0","309719370"
"2022/05/10","341491510","110415110","326352050","77895680","856154350"
"2022/05/09","312293220","57337500","193971800","23355490","586958010"
"2022/05/06","137032380","128733730","466498430","130583710","862848250"
"2022/05/04","266199930","131496240","708670950","57459870","1163826990"
"2022/05/03","906096600","6290000","1373229290","231515400","2517131290"
"2022/05/02","462759940","177891960","463774020","36777870","1141203790"
"2022/04/29","678568470","35255690","734446270","58905360","1507175790"
"2022/04/28","989790650","68193570","1819677490","141700350","3019362060"
"2022/04/27","563740270","0","960046760","95071650","1618858680"
"2022/04/26","189585010","65800","1378797170","59132950","1627580930"
"2022/04/25","419251860","0","1026127130","14828900","1460207890"
"2022/04/22","440248720","0","557692900","211594500","1209536120"
"2022/04/21","303850580","106178530","297060370","69433740","776523220"
"2022/04/20","205302890","0","150047310","4935200","360285400"
"2022/04/19","368359840","0","492873970","4233280","865467090"
"2022/04/18","638236540","0","792257890","21096740","1451591170"
"2022/04/15","321832840","37543310","832740040","155914000","1348030190"
"2022/04/14","234281710","0","680153010","67373820","981808540"
"2022/04/13","435395110","0","170025540","35648980","641069630"
"2022/04/12","254029200","160388120","981381400","54658470","1450457190"
"2022/04/11","247833120","4907700","574924410","31719680","859384910"
"2022/04/08","479364260","703044880","748779600","123786150","2054974890"
"2022/04/07","457518330","104788390","1510520980","126300160","2199127860"
"2022/04/06","3294326760","2356170","1729945950","175194470","5201823350"
"2022/04/05","2999424680","924880040","1749732360","458553260","6132590340"
"2022/04/04","769738100","518722760","2486910470","204707010","3980078340"
"2022/04/01","525133010","512980570","2947404370","397414330","4382932280"
"2022/03/31","594952140","144142630","2195374630","187273670","3121743070"
"2022/03/30","380459170","664224570","2185851870","203829290","3434364900"
"2022/03/29","508349030","664260070","2587795450","265090","3760669640"
"2022/03/28","5962029030","8591582170","34054503690","32452760","48640567650"